"","City","State","Region","Political_Leaning","Population_Change_Decade","Natural_Increase_Decade","Births_Decade","Deaths_Decade","Total_Decade","International_Decade","Domestic_Decade","Population_Change_Annual","Natural_Increase_Annual","Births_Annual","Deaths_Annual","Total._Annual","International_Annual","Domestic_Annual","City_data","GDP_2010","GDP_2018","Population_2010","Population_2018","Decade_GDP_Change","Population_Percent_Change","GDP_Percent_Change"
"1"," United States"," US","  US"," RED",19481418,11621558,36275313,24653755,7859860,7859860,0,1552022,956674,3791712,2835038,595348,595348,0,"United States (Metropolitan Portion)",13845441884000,16504746972000,309321666,326687501,2659305088000,1.05614167033485,1.19207079920455
"2"," Abilene"," TX","  South"," RED",6808,6432,21881,15449,431,3167,-2736,910,609,2361,1752,310,220,90,"Abilene, TX (Metropolitan Statistical Area)",6103245000,6850284000,165585,171150,747039000,1.03360811667724,1.12240029689124
"3"," Akron"," OH","  Midwest"," RED",283,3307,69159,65852,-2597,13086,-15683,-376,0,7196,7196,-354,836,-1190,"Akron, OH (Metropolitan Statistical Area)",30124290000,32912839000,703031,703855,2788549000,1.00117206780355,1.09256812359727
"4"," Albany"," GA","  South"," RED",-7307,5423,18764,13341,-12853,865,-13718,-1114,350,1891,1541,-1465,51,-1516,"Albany, GA (Metropolitan Statistical Area)",5341783000,5324036000,154145,147840,-17747000,0.959096954166532,0.99667770105974
"5"," Albany"," OR","  West"," BLUE",13068,2217,13642,11425,10883,204,10679,2298,202,1512,1310,2087,21,2066,"Albany-Lebanon, OR (Metropolitan Statistical Area)",3572329000,4418178000,116891,127451,845849000,1.09034057369686,1.23677802352471
"6"," Albany"," NY","  Northeast"," BLUE",9668,11001,83501,72500,-858,16398,-17256,-1882,469,8704,8235,-2342,1033,-3375,"Albany-Schenectady-Troy, NY (Metropolitan Statistical Area)",48892808000,52367618000,871082,882263,3474810000,1.01283576058282,1.07106996186433
"7"," Albuquerque"," NM","  West"," BLUE",30955,28587,95682,67095,2884,11273,-8389,3071,1577,9520,7943,1541,753,788,"Albuquerque, NM (Metropolitan Statistical Area)",37518103000,38444417000,889558,914947,926314000,1.02854114065637,1.02468978775393
"8"," Alexandria"," LA","  South"," RED",-1881,3625,18768,15143,-5434,657,-6091,-725,250,1875,1625,-976,15,-991,"Alexandria, LA (Metropolitan Statistical Area)",5612875000,5660041000,154096,152762,47166000,0.991343058872391,1.00840318018841
"9"," Allentown"," PA","  Northeast"," RED",22779,4407,78967,74560,18984,24110,-5126,1426,453,8556,8103,1008,1200,-192,"Allentown-Bethlehem-Easton, PA-NJ (Metropolitan Statistical Area)",37176686000,40511705000,821923,842626,3335019000,1.0251884908927,1.08970726976579
"10"," Altoona"," PA","  Northeast"," RED",-5288,-3044,11809,14853,-2137,266,-2403,-674,-473,1146,1619,-195,30,-225,"Altoona, PA (Metropolitan Statistical Area)",5167803000,5354290000,127045,122503,186487000,0.964248888189224,1.03608632140196
"11"," Amarillo"," TX","  South"," RED",13118,12500,33935,21435,497,6326,-5829,647,990,3314,2324,-342,482,-824,"Amarillo, TX (Metropolitan Statistical Area)",11254504000,12629493000,252664,264406,1374989000,1.04647278599246,1.12217233207256
"12"," Ames"," IA","  Midwest"," RED",7501,3771,11201,7430,3706,6347,-2641,258,324,1140,816,-69,340,-409,"Ames, IA (Metropolitan Statistical Area)",4797514000,5782942000,115925,123093,985428000,1.06183308173388,1.20540388209393
"13"," Anchorage"," AK","  West"," RED",15496,33779,54430,20651,-18670,9059,-27729,-1319,2798,5291,2493,-4126,380,-4506,"Anchorage, AK (Metropolitan Statistical Area)",22369669000,22598036000,383053,397636,228367000,1.0380704497811,1.01020877868153
"14"," Ann Arbor"," MI","  Midwest"," RED",22438,13531,33966,20435,9093,18202,-9109,-1882,1025,3473,2448,-2938,1160,-4098,"Ann Arbor, MI (Metropolitan Statistical Area)",18495449000,21963864000,345717,369483,3468415000,1.06874408837286,1.18752802378574
"15"," Anniston"," AL","  South"," RED",-4921,-926,12345,13271,-3943,554,-4497,-726,-263,1269,1532,-461,14,-475,"Anniston-Oxford, AL (Metropolitan Statistical Area)",4545958000,3950436000,118408,114331,-595522000,0.965568204851024,0.868999669596595
"16"," Appleton"," WI","  Midwest"," RED",12307,10484,25919,15435,1991,1718,273,963,982,2658,1676,-10,117,-127,"Appleton, WI (Metropolitan Statistical Area)",10437458000,11806167000,225948,237011,1368709000,1.04896259316303,1.13113432408542
"17"," Asheville"," NC","  South"," RED",37817,-4461,40584,45045,41934,901,41033,3366,-868,4264,5132,4224,84,4140,"Asheville, NC (Metropolitan Statistical Area)",14911441000,17970247000,425338,459314,3058806000,1.0798800013166,1.20513148259783
"18"," Athens"," GA","  South"," RED",21183,7664,20479,12815,13387,4305,9082,2282,661,2178,1517,1628,352,1276,"Athens-Clarke County, GA (Metropolitan Statistical Area)",7616210000,8955390000,193439,211468,1339180000,1.09320250828427,1.17583286175145
"19"," Atlanta"," GA","  South"," RED",733646,343765,673437,329672,389077,144048,245029,75061,31449,72487,41038,43584,12541,31043,"Atlanta-Sandy Springs-Alpharetta, GA (Metropolitan Statistical Area)",278698042000,357308437000,5302598,5945303,78610395000,1.12120568068709,1.2820629611743
"20"," Atlantic City"," NJ","  Northeast"," BLUE",-10855,3762,28213,24451,-14717,7275,-21992,-319,-75,2718,2793,-236,271,-507,"Atlantic City-Hammonton, NJ (Metropolitan Statistical Area)",13442438000,12863458000,274648,263989,-578980000,0.961190323614226,0.956928943990666
"21"," Auburn"," AL","  South"," RED",24255,7301,16800,9499,16776,4442,12334,886,692,1825,1133,191,303,-112,"Auburn-Opelika, AL (Metropolitan Statistical Area)",4075679000,6013577000,140794,163656,1937898000,1.16237907865392,1.47547856443061
"22"," Augusta"," GA","  South"," RED",44087,19584,68807,49223,24442,5614,18828,4759,1519,7311,5792,3252,289,2963,"Augusta-Richmond County, GA-SC (Metropolitan Statistical Area)",22291829000,24690650000,566694,604221,2398821000,1.06622092346134,1.10760987804096
"23"," Austin"," TX","  South"," RED",510760,149806,239673,89867,355902,62740,293162,61586,14670,26115,11445,46614,5280,41334,"Austin-Round Rock-Georgetown, TX (Metropolitan Statistical Area)",92266233000,134416765000,1727502,2165497,42150532000,1.2535423982143,1.45683594777301
"24"," Bakersfield"," CA","  West"," BLUE",60581,74264,128382,54118,-13469,7091,-20560,6444,6666,13144,6478,-210,81,-291,"Bakersfield, CA (Metropolitan Statistical Area)",45378119000,49864234000,840996,893758,4486115000,1.06273751599294,1.09886075269008
"25"," Baltimore"," MD","  South"," BLUE",89455,85415,309615,224200,5900,63529,-57629,-690,5871,32143,26272,-6487,4412,-10899,"Baltimore-Columbia-Towson, MD (Metropolitan Statistical Area)",160892954000,183093526000,2715738,2800743,22200572000,1.03130088395861,1.13798349429273
"26"," Bangor"," ME","  Northeast"," BLUE",-1783,-1025,13391,14416,-654,829,-1483,331,-216,1378,1594,553,62,491,"Bangor, ME (Metropolitan Statistical Area)",5783863000,6017850000,153861,151817,233987000,0.986715281975289,1.04045514217747
"27"," Barnstable Town"," MA","  Northeast"," BLUE",-2890,-12324,14442,26766,9657,3193,6464,-481,-1393,1524,2917,933,317,616,"Barnstable Town, MA (Metropolitan Statistical Area)",11511568000,12459842000,215899,213471,948274000,0.988754000713296,1.08237574585843
"28"," Baton Rouge"," LA","  South"," RED",28967,39336,104150,64814,-10415,7906,-18321,358,3326,10800,7474,-2986,653,-3639,"Baton Rouge, LA (Metropolitan Statistical Area)",45308808000,51501574000,827629,854526,6192766000,1.03249886120472,1.13667907573291
"29"," Battle Creek"," MI","  Midwest"," RED",-1991,1283,15001,13718,-3249,2544,-5793,110,102,1497,1395,14,198,-184,"Battle Creek, MI (Metropolitan Statistical Area)",5602590000,5766360000,135951,134049,163770000,0.986009665247037,1.02923112346254
"30"," Bay City"," MI","  Midwest"," RED",-4647,-1418,9713,11131,-3171,186,-3357,-576,-182,981,1163,-389,-5,-384,"Bay City, MI (Metropolitan Statistical Area)",3467132000,3481282000,107679,103702,14150000,0.963066150317146,1.0040811829489
"31"," Beaumont"," TX","  South"," RED",3814,12241,49027,36786,-8395,5360,-13755,-1252,925,4998,4073,-2183,353,-2536,"Beaumont-Port Arthur, TX (Metropolitan Statistical Area)",25190886000,28227410000,389251,393815,3036524000,1.01172508227339,1.12054057963662
"32"," Beckley"," WV","  South"," RED",-9147,-2917,12607,15524,-6186,457,-6643,-1387,-597,1125,1722,-784,0,-784,"Beckley, WV (Metropolitan Statistical Area)",4398793000,3820247000,124949,117154,-578546000,0.937614546735068,0.868476193355768
"33"," Bellingham"," WA","  West"," BLUE",28101,6275,20961,14686,21826,3788,18038,4050,542,2204,1662,3490,403,3087,"Bellingham, WA (Metropolitan Statistical Area)",10696209000,13515737000,201545,225197,2819528000,1.11735344464015,1.26360068319533
"34"," Bend"," OR","  West"," BLUE",39964,3342,16324,12982,36236,-263,36499,5787,309,1857,1548,5446,-52,5498,"Bend, OR (Metropolitan Statistical Area)",5194934000,8195615000,157742,191905,3000681000,1.21657516704492,1.57761677049218
"35"," Billings"," MT","  West"," RED",14502,4545,19614,15069,9967,598,9369,1464,354,2007,1653,1115,54,1061,"Billings, MT (Metropolitan Statistical Area)",8304713000,9753350000,167571,180203,1448637000,1.07538297199396,1.17443552835601
"36"," Binghamton"," NY","  Northeast"," BLUE",-13033,-434,23118,23552,-12668,3636,-16304,-1675,-260,2345,2605,-1420,239,-1659,"Binghamton, NY (Metropolitan Statistical Area)",10498150000,10836235000,251489,240366,338085000,0.955771425390375,1.03220424550992
"37"," Birmingham"," AL","  South"," RED",29396,26658,126000,99342,3387,8320,-4933,2468,1728,13084,11356,779,671,108,"Birmingham-Hoover, AL (Metropolitan Statistical Area)",49340750000,55910633000,1061717,1087967,6569883000,1.02472410256217,1.13315328607692
"38"," Bismarck"," ND","  Midwest"," RED",18324,6700,15869,9169,11386,1131,10255,670,581,1636,1055,91,134,-43,"Bismarck, ND (Metropolitan Statistical Area)",5235612000,6937990000,111112,128279,1702378000,1.15450176398589,1.32515358280942
"39"," Blacksburg"," VA","  South"," BLUE",4571,962,13760,12798,3636,5090,-1454,39,-13,1422,1435,51,283,-232,"Blacksburg-Christiansburg, VA (Metropolitan Statistical Area) *",6015292000,7023006000,163131,167492,1007714000,1.02673311632982,1.1675253670146
"40"," Bloomington"," IL","  Midwest"," BLUE",1940,8212,18987,10775,-6357,6019,-12376,-893,631,1877,1246,-1535,567,-2102,"Bloomington, IL (Metropolitan Statistical Area)",10690882000,11802499000,169810,172410,1111617000,1.01531123019846,1.10397804409402
"41"," Bloomington"," IN","  Midwest"," RED",9695,3249,13902,10653,6496,9088,-2592,1138,203,1406,1203,937,1223,-286,"Bloomington, IN (Metropolitan Statistical Area)",5688027000,6546302000,160132,168092,858275000,1.04970899008318,1.15089151299739
"42"," Bloomsburg"," PA","  Northeast"," RED",-2361,-1029,7446,8475,-1264,514,-1778,-261,-225,726,951,-30,8,-38,"Bloomsburg-Berwick, PA (Metropolitan Statistical Area)",3979671000,4033349000,85657,83455,53678000,0.974292819034054,1.01348804964028
"43"," Boise City"," ID","  West"," RED",132636,36840,78969,42129,95236,6060,89176,20291,3522,8479,4957,16684,-75,16759,"Boise City, ID (Metropolitan Statistical Area)",23927255000,31127923000,617866,728911,7200668000,1.1797234351785,1.30093999499734
"44"," Boston"," MA","  Northeast"," BLUE",320424,141612,475777,334165,182147,285199,-103052,13483,12428,50726,38298,1139,24391,-23252,"Boston-Cambridge-Newton, MA-NH (Metropolitan Statistical Area)",340175461000,412855824000,4566348,4859536,72680363000,1.06420623220131,1.21365551408777
"45"," Boulder"," CO","  West"," BLUE",31636,10172,26198,16026,21441,8470,12971,1560,674,2609,1935,896,938,-42,"Boulder, CO (Metropolitan Statistical Area) *",20453633000,25319458000,295037,324636,4865825000,1.1003230103343,1.2378953900268
"46"," Bowling Green"," KY","  South"," RED",20627,5949,19566,13617,14662,4654,10008,2376,697,2228,1531,1677,107,1570,"Bowling Green, KY (Metropolitan Statistical Area)",5620158000,6345352000,159341,176864,725194000,1.10997169592258,1.12903445063288
"47"," Bremerton"," WA","  West"," BLUE",20330,8056,27849,19793,12195,2148,10047,2197,648,3023,2375,1544,75,1469,"Bremerton-Silverdale-Port Orchard, WA (Metropolitan Statistical Area)",9994989000,11512963000,251681,269276,1517974000,1.06990992565986,1.15187350381276
"48"," Bridgeport"," CT","  Northeast"," BLUE",26428,31206,92947,61741,-4739,44863,-49602,-639,2643,9603,6960,-3343,4737,-8080,"Bridgeport-Stamford-Norwalk, CT (Metropolitan Statistical Area)",82853670000,77951236000,919355,943971,-4902434000,1.02677529354819,0.940830213073241
"49"," Brownsville"," TX","  South"," RED",16948,41223,65142,23919,-24410,4200,-28610,1024,3414,6202,2788,-2396,11,-2407,"Brownsville-Harlingen, TX (Metropolitan Statistical Area)",9096646000,10011608000,407630,422139,914962000,1.03559355297696,1.10058234650441
"50"," Brunswick"," GA","  South"," RED",6394,1334,12065,10731,5067,503,4564,497,-32,1248,1280,530,8,522,"Brunswick, GA (Metropolitan Statistical Area)",3861573000,3957917000,112534,118282,96344000,1.05107789645796,1.0249494182811
"51"," Buffalo"," NY","  Northeast"," BLUE",-7631,-4,111885,111889,-6892,24110,-31002,-1794,-324,11823,12147,-1444,1339,-2783,"Buffalo-Cheektowaga, NY (Metropolitan Statistical Area)",56819099000,60321806000,1135627,1129777,3502707000,0.994848660695809,1.06164664807515
"52"," Burlington"," NC","  South"," RED",18354,2158,16914,14756,16212,701,15511,2995,330,1976,1646,2655,67,2588,"Burlington, NC (Metropolitan Statistical Area)",5097987000,5364474000,151431,166514,266487000,1.09960311957261,1.052272985396
"53"," Burlington"," VT","  Northeast"," BLUE",9147,5838,20120,14282,3497,5694,-2197,472,487,2087,1600,-10,323,-333,"Burlington-South Burlington, VT (Metropolitan Statistical Area)",11512362000,12355977000,211538,219939,843615000,1.03971390483034,1.07327905428964
"54"," California"," MD","  South"," BLUE",8366,5788,12990,7202,2616,1323,1293,790,445,1319,874,348,60,288,"California-Lexington Park, MD (Metropolitan Statistical Area)",5901066000,6611288000,105761,112720,710222000,1.06579930220024,1.12035486469733
"55"," Canton"," OH","  Midwest"," RED",-6905,-503,40730,41233,-6051,1073,-7124,-810,-141,4254,4395,-652,25,-677,"Canton-Massillon, OH (Metropolitan Statistical Area)",14361383000,18391465000,404218,398330,4030082000,0.985433602659951,1.28061935260692
"56"," Cape Coral"," FL","  South"," RED",151822,-1952,60521,62473,152286,26032,126254,16107,-1190,6760,7950,17226,2183,15043,"Cape Coral-Fort Myers, FL (Metropolitan Statistical Area)",21680472000,27046186000,620449,754470,5365714000,1.21600647273184,1.24749064503762
"57"," Cape Girardeau"," MO","  Midwest"," RED",495,1287,10455,9168,-771,1220,-1991,-103,132,1080,948,-234,128,-362,"Cape Girardeau, MO-IL (Metropolitan Statistical Area)",3863641000,4012835000,96447,96868,149194000,1.0043650917084,1.03861487130921
"58"," Carbondale"," IL","  Midwest"," BLUE",-3384,1846,14376,12530,-5323,2432,-7755,-930,22,1431,1409,-954,212,-1166,"Carbondale-Marion, IL (Metropolitan Statistical Area)",5510649000,5830177000,139409,136694,319528000,0.980524930241233,1.05798373295051
"59"," Carson City"," NV","  West"," BLUE",647,-1018,5427,6445,1641,-181,1822,714,-39,598,637,752,-43,795,"Carson City, NV (Metropolitan Statistical Area)",3339703000,3240155000,54981,55202,-99548000,1.00401957039705,0.970192559038933
"60"," Casper"," WY","  West"," RED",4410,3455,9996,6541,826,506,320,683,219,953,734,464,103,361,"Casper, WY (Metropolitan Statistical Area)",4484485000,5171022000,75470,79175,686537000,1.04909235457798,1.15309160360666
"61"," Cedar Rapids"," IA","  Midwest"," RED",15084,10308,30195,19887,4995,3145,1850,971,948,3214,2266,36,185,-149,"Cedar Rapids, IA (Metropolitan Statistical Area)",15390555000,17255840000,258440,272061,1865285000,1.05270468967652,1.12119673397093
"62"," Chambersburg"," PA","  Northeast"," RED",5396,3065,16994,13929,2510,1461,1049,448,98,1730,1632,359,53,306,"Chambersburg-Waynesboro, PA (Metropolitan Statistical Area)",5076679000,5583610000,149925,154579,506931000,1.03104218776055,1.09985484605192
"63"," Champaign"," IL","  Midwest"," BLUE",8227,10012,23441,13429,-1912,17285,-19197,-251,857,2405,1548,-1125,1607,-2732,"Champaign-Urbana, IL (Metropolitan Statistical Area)",10330251000,10833954000,218255,226284,503703000,1.03678724427848,1.04875999624791
"64"," Charleston"," WV","  South"," RED",-20911,-5096,27559,32655,-15683,716,-16399,-3206,-920,2631,3551,-2284,-25,-2259,"Charleston, WV (Metropolitan Statistical Area)",13511246000,12113811000,277805,260280,-1397435000,0.936916182214143,0.896572455271705
"65"," Charleston"," SC","  South"," RED",137477,34811,86195,51384,101288,8231,93057,14000,2824,9350,6526,11128,788,10340,"Charleston-North Charleston, SC (Metropolitan Statistical Area)",28482118000,37696866000,667450,788122,9214748000,1.18079556521088,1.3235274848591
"66"," Charlotte"," NC","  South"," RED",392920,110931,281325,170394,280220,49640,230580,43933,10605,31214,20609,33262,5120,28142,"Charlotte-Concord-Gastonia, NC-SC (Metropolitan Statistical Area)",114095994000,146813931000,2250121,2592950,32717937000,1.15236025084873,1.28675798205501
"67"," Charlottesville"," VA","  South"," BLUE",17046,5913,20988,15075,11220,6113,5107,1280,564,2290,1726,719,332,387,"Charlottesville, VA (Metropolitan Statistical Area) *",10304601000,12195054000,201891,217335,1890453000,1.0764967234795,1.18345717607115
"68"," Chattanooga"," TN","  South"," RED",37068,7014,58213,51199,30065,3828,26237,4362,336,6274,5938,4019,424,3595,"Chattanooga, TN-GA (Metropolitan Statistical Area)",22715077000,27374748000,529131,560832,4659671000,1.05991143970019,1.20513560222578
"69"," Cheyenne"," WY","  West"," RED",7615,4474,11829,7355,3119,429,2690,635,395,1269,874,243,1,242,"Cheyenne, WY (Metropolitan Statistical Area)",4687265000,5236630000,92236,98865,549365000,1.07186998568889,1.11720374248096
"70"," Chicago"," IL","  Midwest"," BLUE",-2998,438246,1085985,647739,-441506,197093,-638599,-25619,33924,108425,74501,-59693,15257,-74950,"Chicago-Naperville-Elgin, IL-IN-WI (Metropolitan Statistical Area)",539704813000,611591128000,9470634,9484158,71886315000,1.00142799309951,1.13319561595238
"71"," Chico"," CA","  West"," BLUE",-819,782,22527,21745,-1604,1640,-3244,-11153,-105,2422,2527,-11146,103,-11249,"Chico, CA (Metropolitan Statistical Area)",7918928000,9219915000,219949,230339,1300987000,1.04723822340634,1.16428827235202
"72"," Cincinnati"," OH","  Midwest"," RED",83495,73617,253180,179563,11213,31157,-19944,9272,6613,26892,20279,2740,1547,1193,"Cincinnati, OH-KY-IN (Metropolitan Statistical Area)",109064346000,124948052000,2140715,2211936,15883706000,1.03326972530206,1.1456360999955
"73"," Clarksville"," TN","  South"," RED",33878,27663,47474,19811,5746,6228,-482,3519,2866,5245,2379,641,-55,696,"Clarksville, TN-KY (Metropolitan Statistical Area)",10878472000,11287464000,274959,304301,408992000,1.10671409191916,1.03759645656118
"74"," Cleveland"," TN","  South"," RED",9195,1074,12549,11475,8139,1088,7051,974,58,1406,1348,920,170,750,"Cleveland, TN (Metropolitan Statistical Area)",3889364000,4700727000,115896,123968,811363000,1.06964865051425,1.20861071373109
"75"," Cleveland"," OH","  Midwest"," RED",-28828,14479,212523,198044,-42445,36318,-78763,-5346,539,22003,21464,-5817,1433,-7250,"Cleveland-Elyria, OH (Metropolitan Statistical Area)",107166841000,119327107000,2075478,2053795,12160266000,0.989552768085231,1.11347041572309
"76"," Alene"," ID","  West"," RED",27231,4026,16346,12320,23102,-645,23747,4488,312,1815,1503,4159,-118,4277,"Coeur d'Alene, ID (Metropolitan Statistical Area)",4552849000,5529281000,138848,161209,976432000,1.16104661212261,1.21446615075527
"77"," College Station"," TX","  South"," RED",36060,16008,28760,12752,19989,12665,7324,3393,1511,3041,1530,1883,1063,820,"College Station-Bryan, TX (Metropolitan Statistical Area)",10649757000,13169469000,229458,261335,2519712000,1.13892302730783,1.23659807449128
"78"," Colorado Springs"," CO","  West"," BLUE",100179,47495,87988,40493,52570,11220,41350,8589,4645,9688,5043,3922,523,3399,"Colorado Springs, CO (Metropolitan Statistical Area)",28827832000,34207716000,650500,737202,5379884000,1.13328516525749,1.18662117914382
"79"," Columbia"," MO","  Midwest"," RED",17775,9826,22230,12404,7970,5743,2227,1427,897,2324,1427,534,534,0,"Columbia, MO (Metropolitan Statistical Area)",7835771000,8828039000,190947,206746,992268000,1.08274023681964,1.12663310349422
"80"," Columbia"," SC","  South"," RED",70964,25002,86594,61592,46188,13450,32738,6743,1841,9110,7269,4913,1440,3473,"Columbia, SC (Metropolitan Statistical Area)",32732266000,38443541000,769646,831690,5711275000,1.08061368473298,1.17448455905864
"81"," Columbus"," GA","  South"," RED",12570,15057,42452,27395,-3121,7830,-10951,2837,1184,4313,3129,1658,358,1300,"Columbus, GA-AL (Metropolitan Statistical Area)",13143062000,13466516000,309476,318211,323454000,1.02822512892761,1.02461024683594
"82"," Columbus"," IN","  Midwest"," RED",6996,2922,9717,6795,4104,3974,130,1057,281,1015,734,780,629,151,"Columbus, IN (Metropolitan Statistical Area)",5208278000,6363058000,76818,82722,1154780000,1.07685698664376,1.22172011555451
"83"," Columbus"," OH","  Midwest"," RED",220263,108626,251291,142665,112154,58853,53301,18077,10392,27096,16704,7778,4032,3746,"Columbus, OH (Metropolitan Statistical Area)",93662870000,114675302000,1906366,2104194,21012432000,1.10377230815069,1.22434110763422
"84"," Corpus Christi"," TX","  South"," RED",23999,21115,53060,31945,2943,5884,-2941,327,1822,5382,3560,-1497,392,-1889,"Corpus Christi, TX (Metropolitan Statistical Area)",20436017000,21384640000,404676,428697,948623000,1.0593585979895,1.04641917258143
"85"," Corvallis"," OR","  West"," BLUE",7472,1494,6730,5236,5963,4555,1408,611,117,701,584,499,331,168,"Corvallis, OR (Metropolitan Statistical Area)",3805535000,4705402000,85574,92442,899867000,1.08025802229649,1.23646267870352
"86"," Crestview"," FL","  South"," RED",48939,10408,31828,21420,38062,3974,34088,7143,814,3472,2658,6294,81,6213,"Crestview-Fort Walton Beach-Destin, FL (Metropolitan Statistical Area)",10646812000,13028784000,235932,277666,2381972000,1.17688995134191,1.22372631356692
"87"," Cumberland"," MD","  South"," BLUE",-5988,-2669,8748,11417,-3284,583,-3867,-610,-328,889,1217,-279,38,-317,"Cumberland, MD-WV (Metropolitan Statistical Area)",3645135000,3573987000,103170,97894,-71148000,0.948861103033828,0.980481381348016
"88"," Dallas"," TX","  South"," RED",1206599,517590,903051,385461,686884,237927,448957,117380,50600,97911,47311,66665,20064,46601,"Dallas-Fort Worth-Arlington, TX (Metropolitan Statistical Area)",351672601000,468918434000,6392065,7455756,117245833000,1.16640803871675,1.33339484698724
"89"," Dalton"," GA","  South"," RED",2491,6549,17422,10873,-4009,625,-4634,532,527,1780,1253,8,62,-54,"Dalton, GA (Metropolitan Statistical Area)",5811514000,6856016000,142278,144192,1044502000,1.01345253658331,1.17972975716827
"90"," Danville"," IL","  Midwest"," BLUE",-5867,484,9452,8968,-6361,214,-6575,-944,-27,918,945,-918,19,-937,"Danville, IL (Metropolitan Statistical Area)",3105132000,3285723000,81640,76702,180591000,0.939514943655071,1.05815888020219
"91"," Daphne"," AL","  South"," RED",40969,1650,20641,18991,38880,1343,37537,5379,-22,2304,2326,5377,80,5297,"Daphne-Fairhope-Foley, AL (Metropolitan Statistical Area)",4843331000,5774289000,183112,217855,930958000,1.18973633623138,1.19221440781148
"92"," Davenport"," IA","  Midwest"," RED",-509,8550,43301,34751,-8953,5209,-14162,-872,560,4349,3789,-1425,362,-1787,"Davenport-Moline-Rock Island, IA-IL (Metropolitan Statistical Area)",19110819000,20546922000,379743,380044,1436103000,1.00079264133901,1.07514607301759
"93"," Dayton"," OH","  Midwest"," RED",8331,10890,88783,77893,-2113,13473,-15586,2523,885,9391,8506,1681,785,896,"Dayton-Kettering, OH (Metropolitan Statistical Area)",34885290000,38696669000,799672,805088,3811379000,1.0067727768385,1.10925461706066
"94"," Decatur"," AL","  South"," RED",-1224,915,16512,15597,-2051,998,-3049,459,7,1751,1744,464,110,354,"Decatur, AL (Metropolitan Statistical Area)",5397013000,5541306000,153950,152144,144293000,0.988268918480026,1.02673571473702
"95"," Decatur"," IL","  Midwest"," BLUE",-6768,1045,12367,11322,-7840,463,-8303,-495,35,1258,1223,-530,34,-564,"Decatur, IL (Metropolitan Statistical Area)",6767191000,6523486000,110787,104504,-243705000,0.943287569841227,0.963987273301433
"96"," Deltona"," FL","  South"," RED",78077,-21838,52064,73902,99352,11264,88088,10179,-2823,5740,8563,12953,441,12512,"Deltona-Daytona Beach-Ormond Beach, FL (Metropolitan Statistical Area)",16038219000,18605256000,590506,658186,2567037000,1.1146135687021,1.16005748518586
"97"," Denver"," CO","  West"," BLUE",423631,162267,320151,157884,257992,61997,195995,35574,14935,34138,19203,20531,7266,13265,"Denver-Aurora-Lakewood, CO (Metropolitan Statistical Area) *",145800061000,193965928000,2554523,2931665,48165867000,1.14763695609709,1.33035560252612
"98"," Des Moines"," IA","  Midwest"," RED",92818,40673,85530,44857,51899,11716,40183,8377,4136,9311,5175,4237,519,3718,"Des Moines-West Des Moines, IA (Metropolitan Statistical Area)",34990053000,44481448000,608930,690915,9491395000,1.13463780730133,1.27125980632267
"99"," Detroit"," MI","  Midwest"," RED",23402,84753,462696,377943,-61318,110907,-172225,-2455,6728,48879,42151,-9139,7516,-16655,"Detroit-Warren-Dearborn, MI (Metropolitan Statistical Area)",197274436000,238679503000,4291508,4322084,41405067000,1.00712476826328,1.20988561842853
"100"," Dothan"," AL","  South"," RED",3718,1157,16420,15263,2667,213,2454,1109,34,1749,1715,1080,3,1077,"Dothan, AL (Metropolitan Statistical Area)",4917549000,5196491000,145871,148249,278942000,1.01630207512117,1.05672378658555
"101"," Dover"," DE","  South"," BLUE",18436,6171,20448,14277,12260,2127,10133,2246,370,2127,1757,1874,62,1812,"Dover, DE (Metropolitan Statistical Area)",6812713000,6700040000,162956,178540,-112673000,1.09563317705393,0.98346136113469
"102"," Dubuque"," IA","  Midwest"," RED",3668,2707,11009,8302,1034,815,219,389,229,1136,907,166,60,106,"Dubuque, IA (Metropolitan Statistical Area)",4594294000,5194130000,93929,96922,599836000,1.03186449339395,1.13056108294332
"103"," Duluth"," MN","  Midwest"," BLUE",-1904,-1025,26864,27889,-609,1537,-2146,-528,-270,2746,3016,-243,76,-319,"Duluth, MN-WI (Metropolitan Statistical Area)",13275463000,14265083000,290542,289260,989620000,0.995587557048551,1.07454504599953
"104"," Durham"," NC","  South"," RED",80174,25573,65747,40174,54198,19005,35193,6866,2122,7029,4907,4734,1848,2886,"Durham-Chapel Hill, NC (Metropolitan Statistical Area)",44130089000,48385378000,566267,637501,4255289000,1.12579578184849,1.09642602352332
"105"," East Stroudsburg"," PA","  Northeast"," RED",430,72,13202,13130,344,2408,-2064,977,-73,1545,1618,1064,153,911,"East Stroudsburg, PA (Metropolitan Statistical Area)",6093867000,5673380000,169849,169294,-420487000,0.996732391712639,0.93099832996027
"106"," Eau Claire"," WI","  Midwest"," RED",7921,4752,17465,12713,3273,1041,2232,840,476,1808,1332,370,95,275,"Eau Claire, WI (Metropolitan Statistical Area)",7054355000,8483264000,161655,168464,1428909000,1.04212056540163,1.20255700202216
"107"," El Centro"," CA","  West"," BLUE",6691,18410,27894,9484,-11851,2063,-13914,-308,1649,2728,1079,-1967,33,-2000,"El Centro, CA (Metropolitan Statistical Area)",7005345000,8038068000,174716,181523,1032723000,1.03896036997184,1.14741929198348
"108"," Elizabethtown"," KY","  South"," RED",5597,6204,18197,11993,-784,2157,-2941,727,506,1888,1382,227,-76,303,"Elizabethtown-Fort Knox, KY (Metropolitan Statistical Area)",5640540000,5394199000,149833,153201,-246341000,1.02247835923995,0.956326699216742
"109"," Elkhart"," IN","  Midwest"," RED",8772,13069,28381,15312,-4216,985,-5201,724,1385,3054,1669,-661,209,-870,"Elkhart-Goshen, IN (Metropolitan Statistical Area)",9070640000,12038611000,197451,205617,2967971000,1.04135709619095,1.32720634927635
"110"," Elmira"," NY","  Northeast"," BLUE",-5391,94,8887,8793,-5499,356,-5855,-479,-84,859,943,-394,17,-411,"Elmira, NY (Metropolitan Statistical Area)",3616552000,3625650000,88895,83935,9098000,0.944203835986276,1.00251565579591
"111"," El Paso"," TX","  South"," RED",40015,74054,121572,47518,-34305,18153,-52458,2511,6085,11654,5569,-3575,225,-3800,"El Paso, TX (Metropolitan Statistical Area)",25549042000,29123868000,807048,841613,3574826000,1.04282892715179,1.13992015825877
"112"," Enid"," OK","  South"," RED",476,2377,8684,6307,-1882,1641,-3523,-39,243,864,621,-283,147,-430,"Enid, OK (Metropolitan Statistical Area)",2968388000,3391713000,60765,61095,423325000,1.00543075783757,1.14261107375451
"113"," Erie"," PA","  Northeast"," RED",-10856,2456,28804,26348,-13316,5680,-18996,-1816,54,2855,2801,-1872,525,-2397,"Erie, PA (Metropolitan Statistical Area)",10940781000,11200594000,280799,271544,259813000,0.967040480913394,1.02374720780902
"114"," Eugene"," OR","  West"," BLUE",30362,588,32589,32001,29917,5052,24865,3518,-206,3425,3631,3717,230,3487,"Eugene-Springfield, OR (Metropolitan Statistical Area)",12636699000,15067333000,351920,378549,2430634000,1.07566776540123,1.1923472261229
"115"," Evansville"," IN","  Midwest"," RED",3538,4334,34097,29763,-558,1942,-2500,426,161,3448,3287,279,274,5,"Evansville, IN-KY (Metropolitan Statistical Area)",15914640000,15955374000,311802,314660,40734000,1.00916607334142,1.00255953009305
"116"," Fairbanks"," AK","  West"," RED",-736,11008,15436,4428,-11928,2339,-14267,-1716,1027,1533,506,-2747,16,-2763,"Fairbanks, AK (Metropolitan Statistical Area) *",6172331000,5654089000,98264,98565,-518242000,1.00306317674835,0.916037879368427
"117"," Fargo"," ND","  Midwest"," RED",37368,16854,30570,13716,20299,6674,13625,1834,1793,3362,1569,48,516,-468,"Fargo, ND-MN (Metropolitan Statistical Area)",10415805000,13036357000,209455,244311,2620552000,1.16641283330548,1.25159380383945
"118"," Farmington"," NM","  West"," BLUE",-6087,6996,16172,9176,-13162,109,-13271,-1541,301,1410,1109,-1849,-12,-1837,"Farmington, NM (Metropolitan Statistical Area)",6542934000,5812050000,130203,125499,-730884000,0.963871800188936,0.888294150605829
"119"," Fayetteville"," NC","  South"," RED",45708,42745,77225,34480,1623,14235,-12612,4258,3985,8096,4111,271,363,-92,"Fayetteville, NC (Metropolitan Statistical Area)",19590709000,19302507000,490446,522461,-288202000,1.06527731901168,0.98528884278767
"120"," Fayetteville"," AR","  South"," RED",94783,32777,64207,31430,61505,10695,50810,9665,3594,7154,3560,6043,266,5777,"Fayetteville-Springdale-Rogers, AR (Metropolitan Statistical Area)",17364563000,23481798000,442301,525239,6117235000,1.18751483718101,1.35228269205508
"121"," Flagstaff"," AZ","  West"," RED",9050,7792,15157,7365,1238,1311,-73,953,612,1513,901,338,25,313,"Flagstaff, AZ (Metropolitan Statistical Area)",6109513000,6770442000,134612,142523,660929000,1.05876890618964,1.1081803083159
"122"," Flint"," MI","  Midwest"," RED",-19974,4066,45082,41016,-24248,1840,-26088,-875,43,4600,4557,-909,117,-1026,"Flint, MI (Metropolitan Statistical Area)",12549079000,13455676000,424953,406688,906597000,0.957018776194073,1.07224410651969
"123"," Florence"," SC","  South"," RED",-665,1762,23172,21410,-2246,819,-3065,-125,-47,2351,2398,-69,128,-197,"Florence, SC (Metropolitan Statistical Area)",7514055000,9019299000,205662,205036,1505244000,0.996956170804524,1.20032379321152
"124"," Florence"," AL","  South"," RED",833,-2523,14204,16727,3481,767,2714,362,-349,1506,1855,719,108,611,"Florence-Muscle Shoals, AL (Metropolitan Statistical Area)",4715965000,5222391000,147261,147608,506426000,1.00235636047562,1.10738544497256
"125"," Fond du Lac"," WI","  Midwest"," RED",1780,1399,10048,8649,432,1265,-833,402,157,1068,911,253,74,179,"Fond du Lac, WI (Metropolitan Statistical Area)",4132024000,4779555000,101576,103001,647531000,1.01402890446562,1.15671036760677
"126"," Fort Collins"," CO","  West"," BLUE",57269,11605,31320,19715,45121,4487,40634,6239,1042,3337,2295,5175,537,4638,"Fort Collins, CO (Metropolitan Statistical Area)",12632341000,16793330000,300441,350660,4160989000,1.16715095476316,1.32939175723645
"127"," Fort Smith"," AR","  South"," RED",2128,5187,29653,24466,-2941,1267,-4208,70,559,3228,2669,-482,-24,-458,"Fort Smith, AR-OK (Metropolitan Statistical Area)",8781728000,8755173000,248344,250298,-26555000,1.00786811841639,0.996976107663549
"128"," Fort Wayne"," IN","  Midwest"," RED",24637,20290,51797,31507,4659,5989,-1330,4137,2090,5564,3474,2059,759,1300,"Fort Wayne, IN (Metropolitan Statistical Area)",16559301000,20926252000,389298,409126,4366951000,1.05093270450914,1.26371590201784
"129"," Fresno"," CA","  West"," BLUE",68594,80755,142608,61853,-11772,9639,-21411,7151,7039,14506,7467,131,479,-348,"Fresno, CA (Metropolitan Statistical Area)",36039096000,43436946000,932039,991950,7397850000,1.06427949903384,1.20527290695638
"130"," Gadsden"," AL","  South"," RED",-2161,-1921,10979,12900,-142,273,-415,-343,-312,1175,1487,-25,37,-62,"Gadsden, AL (Metropolitan Statistical Area)",2793082000,2803470000,104459,102611,10388000,0.982308848447716,1.00371918905353
"131"," Gainesville"," FL","  South"," RED",24052,7889,31837,23948,16211,10747,5464,1195,528,3366,2838,661,800,-139,"Gainesville, FL (Metropolitan Statistical Area)",12133089000,13930241000,305334,327933,1797152000,1.07401403053705,1.14811990582118
"132"," Gainesville"," GA","  South"," RED",24717,10762,23794,13032,13974,1471,12503,2903,986,2586,1600,1903,73,1830,"Gainesville, GA (Metropolitan Statistical Area)",6849881000,8764977000,180033,201538,1915096000,1.11945032299634,1.27958091534729
"133"," Gettysburg"," PA","  Northeast"," RED",1581,189,9396,9207,1470,544,926,-53,-53,960,1013,4,54,-50,"Gettysburg, PA (Metropolitan Statistical Area)",3112492000,3487746000,101479,103062,375254000,1.0155992865519,1.12056384401952
"134"," Glens Falls"," NY","  Northeast"," BLUE",-3798,-1334,10739,12073,-2387,350,-2737,-341,-281,1074,1355,-53,30,-83,"Glens Falls, NY (Metropolitan Statistical Area)",5261321000,5354073000,129021,125489,92752000,0.972624611497353,1.01762903270871
"135"," Goldsboro"," NC","  South"," RED",470,4411,15461,11050,-3928,2638,-6566,-106,224,1608,1384,-328,214,-542,"Goldsboro, NC (Metropolitan Statistical Area)",4653982000,4714200000,122886,123237,60218000,1.00285630584444,1.0129390272674
"136"," Grand Forks"," ND","  Midwest"," RED",2351,5350,13041,7691,-3007,1946,-4953,-951,525,1395,870,-1481,96,-1577,"Grand Forks, ND-MN (Metropolitan Statistical Area)",4407945000,5132844000,98633,101766,724899000,1.03176421684426,1.16445282325437
"137"," Grand Island"," NE","  Midwest"," RED",2809,4006,10352,6346,-1166,2408,-3574,77,448,1111,663,-370,208,-578,"Grand Island, NE (Metropolitan Statistical Area)",3562219000,3835271000,72936,75476,273052000,1.03482505210047,1.07665222155067
"138"," Grand Junction"," CO","  West"," BLUE",7477,3078,16342,13264,4431,-173,4604,1259,116,1631,1515,1137,-13,1150,"Grand Junction, CO (Metropolitan Statistical Area)",5651982000,6253144000,146259,152951,601162000,1.04575444929885,1.1063630422036
"139"," Grand Rapids"," MI","  Midwest"," RED",83707,55687,125556,69869,28532,17629,10903,6000,5392,13339,7947,647,1316,-669,"Grand Rapids-Kentwood, MI (Metropolitan Statistical Area)",44769622000,55253905000,994262,1071370,10484283000,1.07755299910889,1.23418296897838
"140"," Grants Pass"," OR","  West"," BLUE",4768,-3219,7810,11029,7981,-140,8121,337,-324,866,1190,667,-26,693,"Grants Pass, OR (Metropolitan Statistical Area)",2066219000,2554777000,82879,87150,488558000,1.0515329576853,1.23645025043328
"141"," Great Falls"," MT","  West"," RED",40,2825,10524,7699,-2753,759,-3512,-322,269,1054,785,-589,6,-595,"Great Falls, MT (Metropolitan Statistical Area)",3352906000,3782722000,81507,81688,429816000,1.00222066816347,1.12819208173447
"142"," Greeley"," CO","  West"," BLUE",71665,22092,37587,15495,49035,2484,46551,9677,2504,4360,1856,7141,363,6778,"Greeley, CO (Metropolitan Statistical Area) *",10481889000,20531235000,254207,314815,10049346000,1.23841987042056,1.9587342510496
"143"," Green Bay"," WI","  Midwest"," RED",16665,13646,36179,22533,3288,3355,-67,1522,1359,3759,2400,171,178,-7,"Green Bay, WI (Metropolitan Statistical Area)",16020371000,18584854000,306754,321384,2564483000,1.04769293961937,1.16007638025362
"144"," Greensboro"," NC","  South"," RED",47928,17401,79920,62519,31027,12830,18197,5378,1171,8520,7349,4239,1182,3057,"Greensboro-High Point, NC (Metropolitan Statistical Area)",37989729000,38301038000,725264,766473,311309000,1.05681930993404,1.00819455700776
"145"," Greenville"," NC","  South"," RED",12566,7944,19462,11518,4658,1371,3287,1167,621,2053,1432,545,101,444,"Greenville, NC (Metropolitan Statistical Area)",7185539000,7778281000,168863,179575,592742000,1.06343603986664,1.08249095857666
"146"," Greenville"," SC","  South"," RED",96446,21138,96861,75723,75133,13917,61216,13449,1764,10516,8752,11656,1825,9831,"Greenville-Anderson, SC (Metropolitan Statistical Area)",31919727000,41116111000,825625,907028,9196384000,1.09859560938683,1.28810973226682
"147"," Gulfport"," MS","  South"," RED",29074,10483,46703,36220,18654,5595,13059,2979,758,4842,4084,2219,173,2046,"Gulfport-Biloxi, MS (Metropolitan Statistical Area)",18215065000,17258609000,389324,414686,-956456000,1.06514368495135,0.947490936760313
"148"," Hagerstown"," MD","  South"," BLUE",18958,4626,29793,25167,14324,1742,12582,2382,279,3174,2895,2108,14,2094,"Hagerstown-Martinsburg, MD-WV (Metropolitan Statistical Area)",9202862000,10397915000,269833,285722,1195053000,1.05888456934474,1.1298566685016
"149"," Hammond"," LA","  South"," RED",13649,6635,17863,11228,7015,508,6507,921,570,1953,1383,351,1,350,"Hammond, LA (Metropolitan Statistical Area)",3813167000,3894065000,121485,133837,80898000,1.10167510392229,1.02121543588309
"150"," Hanford"," CA","  West"," BLUE",-34,14271,21880,7609,-14649,695,-15344,1558,1434,2321,887,123,-74,197,"Hanford-Corcoran, CA (Metropolitan Statistical Area)",5233245000,5648724000,152370,151382,415479000,0.993515783946971,1.07939223177971
"151"," Harrisburg"," PA","  Northeast"," RED",28497,11803,60274,48471,17028,14620,2408,3792,1071,6430,5359,2749,1084,1665,"Harrisburg-Carlisle, PA (Metropolitan Statistical Area)",31248130000,35907508000,550088,574149,4659378000,1.04374027428339,1.14910901868368
"152"," Harrisonburg"," VA","  South"," BLUE",9743,4037,13181,9144,5728,4229,1499,215,380,1435,1055,-169,257,-426,"Harrisonburg, VA (Metropolitan Statistical Area) *",5974229000,6145145000,125401,134749,170916000,1.07454486008883,1.02860887990735
"153"," Hartford"," CT","  Northeast"," BLUE",-7594,13025,110209,97184,-20759,47395,-68154,-1262,633,11508,10875,-1910,4140,-6050,"Hartford-East Hartford-Middletown, CT (Metropolitan Statistical Area)",87801792000,89529174000,1214091,1206139,1727382000,0.993450243844984,1.01967365313
"154"," Hattiesburg"," MS","  South"," RED",6431,6332,20737,14405,32,1356,-1324,557,609,2158,1549,-54,190,-244,"Hattiesburg, MS (Metropolitan Statistical Area)",5545815000,5937472000,162856,168292,391657000,1.03337918160829,1.07062208169584
"155"," Hickory"," NC","  South"," RED",3917,-1716,34817,36533,5910,2924,2986,1262,-424,3691,4115,1703,356,1347,"Hickory-Lenoir-Morganton, NC (Metropolitan Statistical Area)",13280354000,14032872000,365565,368449,752518000,1.0078891578789,1.05666400157707
"156"," Hilton Head Island"," SC","  South"," RED",35185,5746,21847,16101,29093,3536,25557,4172,266,2289,2023,3884,244,3640,"Hilton Head Island-Bluffton, SC (Metropolitan Statistical Area)",6536780000,7473309000,187777,218023,936529000,1.16107403995164,1.14327069290996
"157"," Hinesville"," GA","  South"," RED",3065,11489,15546,4057,-8903,2563,-11466,1297,1134,1631,497,165,-44,209,"Hinesville, GA (Metropolitan Statistical Area)",3671014000,3333441000,77339,79697,-337573000,1.03048914519195,0.908043663140484
"158"," Homosassa Springs"," FL","  South"," RED",8427,-13385,9689,23074,21756,331,21425,1975,-1640,1066,2706,3601,-18,3619,"Homosassa Springs, FL (Metropolitan Statistical Area)",3630748000,3511018000,141173,147682,-119730000,1.04610655011936,0.967023324119438
"159"," Hot Springs"," AR","  South"," RED",3387,-2502,10186,12688,5924,-10,5934,420,-276,1071,1347,699,-27,726,"Hot Springs, AR (Metropolitan Statistical Area)",2781577000,3051825000,96067,98966,270248000,1.0301768557361,1.09715639725235
"160"," Houma"," LA","  South"," RED",-110,8581,26337,17756,-8622,1553,-10175,-1069,591,2623,2032,-1659,49,-1708,"Houma-Thibodaux, LA (Metropolitan Statistical Area)",11053254000,9514520000,208251,209144,-1538734000,1.00428809465501,0.860789049089074
"161"," Houston"," TX","  South"," RED",1145654,540027,889610,349583,602610,333553,269057,89994,52016,95261,43245,37893,30746,7147,"Houston-The Woodlands-Sugar Land, TX (Metropolitan Statistical Area)",381346585000,445335360000,5947236,6976147,63988775000,1.17300658658913,1.16779690055439
"162"," Huntington"," WV","  South"," RED",-15026,-3285,37621,40906,-11546,359,-11905,-3196,-808,3608,4416,-2388,-70,-2318,"Huntington-Ashland, WV-KY-OH (Metropolitan Statistical Area)",13923243000,15057783000,371065,359069,1134540000,0.967671432228855,1.08148532637116
"163"," Huntsville"," AL","  South"," RED",54231,13388,47880,34492,40771,4833,35938,8643,1087,5256,4169,7528,262,7266,"Huntsville, AL (Metropolitan Statistical Area)",22067533000,24995035000,419276,463181,2927502000,1.10471622511186,1.13266104552783
"164"," Idaho Falls"," ID","  West"," RED",18199,13197,22463,9266,5038,222,4816,3094,1350,2402,1052,1741,-34,1775,"Idaho Falls, ID (Metropolitan Statistical Area)",5366394000,6432097000,133813,148436,1065703000,1.10927936747551,1.19858828852298
"165"," Indianapolis"," IN","  Midwest"," RED",186462,97491,246099,148608,89578,43502,46076,22169,9622,26300,16678,12590,6394,6196,"Indianapolis-Carmel-Anderson, IN (Metropolitan Statistical Area)",113733987000,124667768000,1892640,2052368,10933781000,1.08439428523121,1.09613468487656
"166"," Iowa City"," IA","  Midwest"," RED",20519,10606,19234,8628,9929,7862,2067,498,1015,2005,990,-520,477,-997,"Iowa City, IA (Metropolitan Statistical Area)",8028180000,9533554000,153025,172607,1505374000,1.12796601862441,1.18751124165128
"167"," Ithaca"," NY","  Northeast"," BLUE",588,1506,7735,6229,-981,6686,-7667,-239,106,742,636,-350,447,-797,"Ithaca, NY (Metropolitan Statistical Area)",5434918000,5412942000,101740,102419,-21976000,1.00667387458227,0.995956516731255
"168"," Jackson"," MI","  Midwest"," RED",-1723,1215,16506,15291,-2843,698,-3541,-56,120,1743,1623,-170,30,-200,"Jackson, MI (Metropolitan Statistical Area)",4887513000,5662101000,160109,158566,774588000,0.990362815332055,1.15848305672026
"169"," Jackson"," MS","  South"," RED",7691,21259,70872,49613,-13741,4965,-18706,-2570,1480,7091,5611,-4062,457,-4519,"Jackson, MS (Metropolitan Statistical Area)",23547730000,25445532000,588272,597376,1897802000,1.01547583430794,1.08059384068018
"170"," Jackson"," TN","  South"," RED",-1067,1711,20312,18601,-2675,730,-3405,329,123,2101,1978,214,92,122,"Jackson, TN (Metropolitan Statistical Area)",7225810000,7571807000,179762,178315,345997000,0.991950467840812,1.04788348987864
"171"," Jacksonville"," FL","  South"," RED",213920,52866,167526,114660,160572,34089,126483,26851,4503,18592,14089,22302,2251,20051,"Jacksonville, FL (Metropolitan Statistical Area)",60122228000,73723680000,1348907,1532663,13601452000,1.13622584803845,1.22623000598048
"172"," Jacksonville"," NC","  South"," RED",20137,29255,38784,9529,-10285,7624,-17909,1023,2857,3951,1094,-1815,-2,-1813,"Jacksonville, NC (Metropolitan Statistical Area)",8436348000,8155742000,186892,196915,-280606000,1.05362990390172,0.966738451282474
"173"," Janesville"," WI","  Midwest"," RED",3029,4270,17881,13611,-1131,397,-1528,480,406,1877,1471,81,39,42,"Janesville-Beloit, WI (Metropolitan Statistical Area)",5817471000,7013004000,160260,162874,1195533000,1.01631099463372,1.20550734159225
"174"," Jefferson City"," MO","  Midwest"," RED",1415,4291,16332,12041,-2813,962,-3775,-277,264,1680,1416,-540,88,-628,"Jefferson City, MO (Metropolitan Statistical Area)",6595308000,6682865000,149991,151512,87557000,1.01014060843651,1.01327564990141
"175"," Johnson City"," TN","  South"," RED",4892,-3314,18323,21637,8285,1307,6978,749,-537,1869,2406,1291,200,1091,"Johnson City, TN (Metropolitan Statistical Area)",6217556000,6981674000,199010,202900,764118000,1.0195467564444,1.1228968424249
"176"," Johnstown"," PA","  Northeast"," RED",-13503,-4708,12304,17012,-8837,384,-9221,-1257,-509,1218,1727,-745,29,-774,"Johnstown, PA (Metropolitan Statistical Area)",4764548000,4550684000,143461,131449,-213864000,0.916269927018493,0.955113475611957
"177"," Jonesboro"," AR","  South"," RED",12841,4763,16354,11591,8072,1239,6833,1141,402,1766,1364,739,43,696,"Jonesboro, AR (Metropolitan Statistical Area)",4337626000,4587993000,121263,132719,250367000,1.09447234523309,1.05771982185647
"178"," Joplin"," MO","  Midwest"," RED",4055,5310,22013,16703,-1152,1212,-2364,951,424,2235,1811,532,106,426,"Joplin, MO (Metropolitan Statistical Area)",6563466000,7015093000,175833,178613,451627000,1.01581045651271,1.06880922366323
"179"," Kahului"," HI","  West"," BLUE",12577,7138,18012,10874,5518,6138,-620,445,388,1834,1446,65,582,-517,"Kahului-Wailuku-Lahaina, HI (Metropolitan Statistical Area)",7504598000,9345639000,155020,166972,1841041000,1.07709972906722,1.24532173475515
"180"," Kalamazoo"," MI","  Midwest"," RED",14739,9446,28774,19328,5485,4483,1002,386,801,3010,2209,-412,303,-715,"Kalamazoo-Portage, MI (Metropolitan Statistical Area)",10798629000,12530386000,250751,264680,1731757000,1.05554913041224,1.16036822822601
"181"," Kankakee"," IL","  Midwest"," BLUE",-3588,1946,12271,10325,-5547,530,-6077,-91,73,1240,1167,-163,29,-192,"Kankakee, IL (Metropolitan Statistical Area)",4145461000,4370611000,113418,109953,225150000,0.969449293762895,1.05431241543462
"182"," Kansas City"," MO","  Midwest"," RED",148635,98218,253384,155166,51716,27259,24457,13563,8805,26497,17692,4814,2377,2437,"Kansas City, MO-KS (Metropolitan Statistical Area)",104035356000,120352988000,2013361,2144427,16317632000,1.06509811206237,1.15684698574973
"183"," Kennewick"," WA","  West"," BLUE",46284,23159,39288,16129,23058,3571,19487,4323,2224,4151,1927,2100,316,1784,"Kennewick-Richland, WA (Metropolitan Statistical Area)",12751790000,13934458000,255542,295289,1182668000,1.15553998951249,1.09274525380358
"184"," Killeen"," TX","  South"," RED",54995,43397,68686,25289,11142,13598,-2456,9031,4057,7039,2982,4937,125,4812,"Killeen-Temple, TX (Metropolitan Statistical Area)",16242831000,16837964000,408262,451272,595133000,1.10534901607301,1.03663973355384
"185"," Kingsport"," TN","  South"," RED",-2291,-9185,26943,36128,7135,-122,7257,466,-1151,2776,3927,1627,-19,1646,"Kingsport-Bristol, TN-VA (Metropolitan Statistical Area) *",11695114000,12037030000,309480,306736,341916000,0.991133514282021,1.02923579881308
"186"," Kingston"," NY","  Northeast"," BLUE",-4946,-1139,14405,15544,-3751,2456,-6207,-845,-310,1433,1743,-529,148,-677,"Kingston, NY (Metropolitan Statistical Area)",6096100000,6237082000,182418,178418,140982000,0.978072339352476,1.02312658913076
"187"," Knoxville"," TN","  South"," RED",54021,1643,84244,82601,52546,7094,45452,7812,-260,8995,9255,8067,985,7082,"Knoxville, TN (Metropolitan Statistical Area)",33420711000,38756940000,815984,861234,5336229000,1.05545451871605,1.15966832662537
"188"," Kokomo"," IN","  Midwest"," RED",-204,153,9085,8932,-290,341,-631,287,-4,946,950,298,37,261,"Kokomo, IN (Metropolitan Statistical Area)",4078017000,5253267000,82752,82257,1175250000,0.994018271461717,1.28819154015297
"189"," La Crosse"," WI","  Midwest"," RED",2958,2447,13220,10773,572,341,231,3,171,1364,1193,-160,-11,-149,"La Crosse-Onalaska, WI-MN (Metropolitan Statistical Area)",6158086000,6993246000,133897,136613,835160000,1.02028424834014,1.13562006116836
"190"," Lafayette"," LA","  South"," RED",22474,23870,62244,38374,-1317,4234,-5551,-473,1726,6331,4605,-2196,222,-2418,"Lafayette, LA (Metropolitan Statistical Area)",22495876000,21388685000,467612,489680,-1107191000,1.0471929719511,0.950782490088406
"191"," Lafayette"," IN","  Midwest"," RED",22692,10837,24792,13955,11914,15527,-3613,2064,1057,2617,1560,999,2091,-1092,"Lafayette-West Lafayette, IN (Metropolitan Statistical Area)",8451301000,9727016000,210687,230938,1275715000,1.0961188872593,1.15094894857017
"192"," Lake Charles"," LA","  South"," RED",10769,7932,26736,18804,2976,1153,1823,219,867,2983,2116,-647,54,-701,"Lake Charles, LA (Metropolitan Statistical Area)",12870281000,16334545000,199943,210190,3464264000,1.05124960613775,1.26916770504078
"193"," Lake Havasu City"," AZ","  West"," RED",11999,-9685,16886,26571,21585,-1496,23081,2889,-1623,1752,3375,4478,-246,4724,"Lake Havasu City-Kingman, AZ (Metropolitan Statistical Area)",4620074000,5068013000,200314,209292,447939000,1.04481963317591,1.09695494054857
"194"," Lakeland"," FL","  South"," RED",122704,9786,69821,60035,112597,23260,89337,18180,806,8043,7237,17311,673,16638,"Lakeland-Winter Haven, FL (Metropolitan Statistical Area)",19958101000,22483500000,603102,706597,2525399000,1.17160447154876,1.12653503457067
"195"," Lancaster"," PA","  Northeast"," RED",26281,20139,65415,45276,6589,11759,-5170,1755,1972,7132,5160,-205,647,-852,"Lancaster, PA (Metropolitan Statistical Area)",23225493000,26442386000,520319,543969,3216893000,1.04545288563362,1.13850698454496
"196"," Lansing"," MI","  Midwest"," RED",15707,14093,54679,40586,1625,19865,-18240,1717,1125,5702,4577,612,1452,-840,"Lansing-East Lansing, MI (Metropolitan Statistical Area)",20916226000,22247293000,534899,548674,1331067000,1.02575252524308,1.06363801003106
"197"," Laredo"," TX","  South"," RED",26348,36433,48554,12121,-10078,7043,-17121,1532,3357,4735,1378,-1831,377,-2208,"Laredo, TX (Metropolitan Statistical Area)",7932647000,12408193000,251370,275120,4475546000,1.09448223733938,1.56419326361049
"198"," Las Cruces"," NM","  West"," BLUE",8978,12954,27022,14068,-4004,2240,-6244,917,1015,2630,1615,-96,128,-224,"Las Cruces, NM (Metropolitan Statistical Area)",7017937000,6757266000,210097,217278,-260671000,1.03417945044432,0.962856463373781
"199"," Las Vegas"," NV","  West"," BLUE",315447,105372,247787,142415,208889,23319,185570,40600,9129,27048,17919,31283,-360,31643,"Las Vegas-Henderson-Paradise, NV (Metropolitan Statistical Area)",89183882000,107622947000,1952587,2226115,18439065000,1.14008492323261,1.20675333464403
"200"," Lawrence"," KS","  Midwest"," RED",11433,4907,11149,6242,6564,5122,1442,1150,420,1107,687,729,387,342,"Lawrence, KS (Metropolitan Statistical Area)",3894698000,4458646000,111198,121109,563948000,1.08912930088671,1.14479890353501
"201"," Lawton"," OK","  South"," RED",-3873,7691,17852,10161,-11769,2831,-14600,67,523,1693,1170,-454,56,-510,"Lawton, OK (Metropolitan Statistical Area)",5064137000,4605279000,131569,126348,-458858000,0.96031739999544,0.909390681966147
"202"," Lebanon"," PA","  Northeast"," RED",8196,1613,15092,13479,6716,4877,1839,454,77,1581,1504,384,124,260,"Lebanon, PA (Metropolitan Statistical Area)",4882116000,5659207000,133664,141339,777091000,1.05742009815657,1.15917094145244
"203"," Lewiston"," ID","  West"," RED",2097,-293,6567,6860,2421,-204,2625,118,-38,680,718,161,-47,208,"Lewiston, ID-WA (Metropolitan Statistical Area)",2319237000,2572585000,61040,62872,253348000,1.0300131061599,1.10923765014097
"204"," Lewiston"," ME","  Northeast"," BLUE",568,1802,11771,9969,-1187,1143,-2330,363,124,1208,1084,242,92,150,"Lewiston-Auburn, ME (Metropolitan Statistical Area)",3966367000,4266879000,107708,107914,300512000,1.00191257845285,1.07576505149423
"205"," Lexington"," KY","  South"," RED",44953,21545,57894,36349,23522,11848,11674,2118,1933,6086,4153,195,259,-64,"Lexington-Fayette, KY (Metropolitan Statistical Area)",22126118000,26125987000,473412,514938,3999869000,1.08771640769562,1.1807759047475
"206"," Lima"," OH","  Midwest"," RED",-3962,1560,11697,10137,-5522,175,-5697,-374,135,1214,1079,-509,-8,-501,"Lima, OH (Metropolitan Statistical Area)",7160776000,7558930000,106358,102725,398154000,0.965841779649862,1.05560207441205
"207"," Lincoln"," NE","  Midwest"," RED",34217,18243,38980,20737,16106,8917,7189,2574,1770,4077,2307,814,808,6,"Lincoln, NE (Metropolitan Statistical Area)",14660135000,17243457000,302961,333800,2583322000,1.10179197982579,1.17621406624155
"208"," Little Rock"," AR","  South"," RED",42594,28130,88569,60439,14662,7696,6966,2303,2179,9010,6831,143,168,-25,"Little Rock-North Little Rock-Conway, AR (Metropolitan Statistical Area)",31495053000,34579355000,702294,740081,3084302000,1.05380510156715,1.0979297288371
"209"," Logan"," UT","  West"," RED",16723,17562,23357,5795,-854,2240,-3094,2061,1730,2396,666,330,233,97,"Logan, UT-ID (Metropolitan Statistical Area)",4303415000,5118853000,126167,140104,815438000,1.11046470154636,1.18948625684485
"210"," Longview"," TX","  South"," RED",6650,7553,34504,26951,-805,1888,-2693,1342,362,3364,3002,992,46,946,"Longview, TX (Metropolitan Statistical Area)",16237294000,16073025000,280487,285315,-164269000,1.01721291895881,0.989883228079753
"211"," Longview"," WA","  West"," BLUE",8185,1106,11376,10270,7099,265,6834,1841,153,1287,1134,1686,22,1664,"Longview, WA (Metropolitan Statistical Area)",4095320000,4511489000,102358,108752,416169000,1.06246702749174,1.10162063037809
"212"," Los Angeles"," CA","  West"," BLUE",385842,753642,1500780,747138,-362998,377442,-740440,-35080,59687,149369,89682,-94938,27228,-122166,"Los Angeles-Long Beach-Anaheim, CA (Metropolitan Statistical Area)",761847125000,941064112000,12838417,13249879,179216987000,1.0320492783495,1.23524009098282
"213"," Louisville/Jefferson County"," KY","  South"," RED",62422,31671,141702,110031,31536,20169,11367,3085,2852,14990,12138,278,671,-393,"Louisville/Jefferson County, KY-IN (Metropolitan Statistical Area)",55875185000,64061796000,1204655,1262023,8186611000,1.0476219332506,1.14651604285516
"214"," Lubbock"," TX","  South"," RED",31368,15696,38925,23229,15616,3403,12213,3018,1354,4068,2714,1666,252,1414,"Lubbock, TX (Metropolitan Statistical Area)",11366277000,13091760000,292241,319239,1725483000,1.09238265677985,1.15180722764367
"215"," Lynchburg"," VA","  South"," BLUE",10912,1841,26279,24438,9174,3531,5643,673,40,2844,2804,643,267,376,"Lynchburg, VA (Metropolitan Statistical Area) *",9678667000,9480986000,252969,262893,-197681000,1.03923010329329,0.979575596515512
"216"," Macon"," GA","  South"," RED",-2249,4907,27200,22293,-7136,1769,-8905,402,41,2694,2653,378,143,235,"Macon-Bibb County, GA (Metropolitan Statistical Area)",9731657000,10423624000,232199,229594,691967000,0.988781174768194,1.07110474608795
"217"," Madera"," CA","  West"," BLUE",6493,11128,20999,9871,-4704,-383,-4321,445,1048,2108,1060,-603,-139,-464,"Madera, CA (Metropolitan Statistical Area)",5021701000,7099931000,150986,156882,2078230000,1.03904997814367,1.41384980905872
"218"," Madison"," WI","  Midwest"," RED",59399,28060,67559,39499,31480,15600,15880,4938,2535,6988,4453,2406,988,1418,"Madison, WI (Metropolitan Statistical Area)",36007275000,46529232000,606625,659927,10521957000,1.08786647434577,1.2922175310406
"219"," Manchester"," NH","  Northeast"," BLUE",16319,9873,39447,29574,6672,13569,-6897,2395,758,4148,3390,1652,1002,650,"Manchester-Nashua, NH (Metropolitan Statistical Area)",21500647000,25514840000,401055,414630,4014193000,1.03384822530576,1.18670103276427
"220"," Manhattan"," KS","  Midwest"," RED",3191,15192,21877,6685,-12490,7782,-20272,-1413,1310,2052,742,-2728,446,-3174,"Manhattan, KS (Metropolitan Statistical Area)",6825812000,6264831000,128521,131698,-560981000,1.02471969561395,0.917814759621273
"221"," Mankato"," MN","  Midwest"," BLUE",5185,3828,10317,6489,1386,1510,-124,350,339,1068,729,12,137,-125,"Mankato, MN (Metropolitan Statistical Area)",4601824000,5476129000,96844,101577,874305000,1.04887241336583,1.18999096879846
"222"," Mansfield"," OH","  Midwest"," RED",-3320,-161,12743,12904,-3129,238,-3367,167,-78,1319,1397,251,11,240,"Mansfield, OH (Metropolitan Statistical Area)",4099234000,4395247000,124162,120987,296013000,0.97442856912743,1.07221178395769
"223"," McAllen"," TX","  South"," RED",93943,105539,143366,37827,-11366,11748,-23114,6409,9457,14054,4597,-3056,-18,-3038,"McAllen-Edinburg-Mission, TX (Metropolitan Statistical Area)",17299088000,21017756000,779149,862298,3718668000,1.1067177138134,1.21496323968061
"224"," Medford"," OR","  West"," BLUE",17740,44,21343,21299,17697,-141,17838,1533,-74,2251,2325,1611,-41,1652,"Medford, OR (Metropolitan Statistical Area)",6853863000,8219635000,203341,219411,1365772000,1.07902980707285,1.19927039685503
"225"," Memphis"," TN","  South"," RED",29943,64370,170921,106551,-34521,13637,-48158,3548,5367,17720,12353,-1816,1656,-3472,"Memphis, TN-MS-AR (Metropolitan Statistical Area)",62073791000,67981434000,1317489,1342497,5907643000,1.01898156265441,1.09517129379129
"226"," Merced"," CA","  West"," BLUE",21884,23063,38618,15555,-1110,463,-1573,3529,2299,4086,1787,1237,-144,1381,"Merced, CA (Metropolitan Statistical Area)",7674491000,9435667000,256721,274151,1761176000,1.06789471839078,1.22948440489408
"227"," Miami"," FL","  South"," RED",600214,178095,626897,448802,422703,615283,-192580,22651,14384,67565,53181,8204,58819,-50615,"Miami-Fort Lauderdale-Pompano Beach, FL (Metropolitan Statistical Area)",257860365000,315031150000,5583394,6143837,57170785000,1.10037676008535,1.2217121851976
"228"," Michigan City"," IN","  Midwest"," RED",-1578,1109,12075,10966,-2616,81,-2697,-93,33,1248,1215,-120,7,-127,"Michigan City-La Porte, IN (Metropolitan Statistical Area)",3893457000,3940402000,111459,109981,46945000,0.986739518567366,1.01205740810801
"229"," Midland"," MI","  Midwest"," RED",-465,1232,7933,6701,-1688,1160,-2848,-67,112,855,743,-177,64,-241,"Midland, MI (Metropolitan Statistical Area)",4085975000,4917510000,83651,83223,831535000,0.994883504082438,1.20350956626019
"230"," Midland"," TX","  South"," RED",40932,15880,26136,10256,24557,3307,21250,4417,1894,3084,1190,2509,328,2181,"Midland, TX (Metropolitan Statistical Area)",12279813000,35002235000,141783,178186,22722422000,1.25675151463857,2.85038827545664
"231"," Milwaukee"," WI","  Midwest"," RED",19225,59009,182815,123806,-39097,25298,-64395,1184,5117,18927,13810,-3863,1277,-5140,"Milwaukee-Waukesha, WI (Metropolitan Statistical Area)",84669359000,92558816000,1556678,1573995,7889457000,1.01112433014406,1.09317959995422
"232"," Minneapolis"," MN","  Midwest"," BLUE",306415,209124,419634,210510,99485,87847,11638,29982,20312,44602,24290,9847,6645,3202,"Minneapolis-St. Paul-Bloomington, MN-WI (Metropolitan Statistical Area)",197700163000,237140794000,3340007,3610061,39440631000,1.0808543215628,1.19949721032855
"233"," Missoula"," MT","  West"," RED",10304,3212,11126,7914,7109,1271,5838,960,244,1131,887,715,112,603,"Missoula, MT (Metropolitan Statistical Area)",4302191000,5004429000,109467,118640,702238000,1.08379694337106,1.16322799243455
"234"," Mobile"," AL","  South"," RED",-1183,11538,53087,41549,-12486,4885,-17371,-774,841,5608,4767,-1606,280,-1886,"Mobile, AL (Metropolitan Statistical Area)",18403592000,18683075000,430941,430310,279483000,0.998535762436157,1.01518632884276
"235"," Modesto"," CA","  West"," BLUE",36210,32649,70420,37771,3879,4607,-728,2534,3076,7393,4317,-535,144,-679,"Modesto, CA (Metropolitan Statistical Area)",18274699000,23160773000,515145,548126,4886074000,1.06402275087597,1.26736823408145
"236"," Monroe"," LA","  South"," RED",-4226,6291,26371,20080,-10438,779,-11217,-1877,363,2606,2243,-2241,44,-2285,"Monroe, LA (Metropolitan Statistical Area)",7371500000,8514155000,204675,202138,1142655000,0.987604739220716,1.15500983517602
"237"," Monroe"," MI","  Midwest"," RED",-1531,841,14053,13212,-2352,285,-2637,326,-22,1459,1481,359,-10,369,"Monroe, MI (Metropolitan Statistical Area)",5295498000,5644944000,151936,150174,349446000,0.98840301179444,1.06598926106666
"238"," Montgomery"," AL","  South"," RED",-1250,12067,44789,32722,-13366,4233,-17599,268,1063,4730,3667,-792,329,-1121,"Montgomery, AL (Metropolitan Statistical Area)",15437132000,16226932000,375119,373022,789800000,0.994409773965062,1.05116235321431
"239"," Morgantown"," WV","  South"," RED",9342,3498,13166,9668,5765,3321,2444,-160,285,1380,1095,-440,-26,-414,"Morgantown, WV (Metropolitan Statistical Area)",6337272000,6869987000,130308,139204,532715000,1.06826902415815,1.08406061788101
"240"," Morristown"," TN","  South"," RED",5891,-1020,13994,15014,6971,839,6132,971,-213,1475,1688,1184,72,1112,"Morristown, TN (Metropolitan Statistical Area)",4012065000,4694391000,136945,141778,682326000,1.03529154039943,1.17006853079399
"241"," Mount Vernon"," WA","  West"," BLUE",12313,2574,13426,10852,9769,1610,8159,1370,166,1431,1265,1200,170,1030,"Mount Vernon-Anacortes, WA (Metropolitan Statistical Area)",6320188000,7469437000,116944,127835,1149249000,1.09313004514982,1.1818377871038
"242"," Muncie"," IN","  Midwest"," RED",-3535,-272,11071,11343,-3241,1422,-4663,-162,-106,1081,1187,-53,180,-233,"Muncie, IN (Metropolitan Statistical Area)",3474690000,3872532000,117665,114297,397842000,0.971376365104322,1.11449712060644
"243"," Muskegon"," MI","  Midwest"," RED",1372,3782,19514,15732,-2385,547,-2932,-33,301,2071,1770,-330,32,-362,"Muskegon, MI (Metropolitan Statistical Area)",5251946000,6004546000,171913,173599,752600000,1.00980728624362,1.1432992646916
"244"," Myrtle Beach"," SC","  South"," RED",120326,-3999,38280,42279,122581,2288,120293,15916,-1429,4188,5617,17201,257,16944,"Myrtle Beach-Conway-North Myrtle Beach, SC-NC (Metropolitan Statistical Area)",12247642000,14851812000,378343,480985,2604170000,1.27129350880022,1.21262623450294
"245"," Napa"," CA","  West"," BLUE",1209,1784,13062,11278,-469,1157,-1626,-1045,-44,1235,1279,-998,-13,-985,"Napa, CA (Metropolitan Statistical Area)",7826910000,9999759000,136759,138789,2172849000,1.01484363003532,1.27761262107268
"246"," Naples"," FL","  South"," RED",63380,109,29806,29697,63056,20167,42889,6701,-707,3160,3867,7391,1906,5485,"Naples-Marco Island, FL (Metropolitan Statistical Area)",12562749000,15760299000,322581,378201,3197550000,1.17242181033601,1.25452629834441
"247"," Nashville-Davidson--Murfreesboro"," TN","  South"," RED",288134,88741,216969,128228,197758,39422,158336,29591,9186,24308,15122,20419,4937,15482,"Nashville-Davidson--Murfreesboro--Franklin, TN (Metropolitan Statistical Area)",86119433000,117839496000,1650831,1904726,31720063000,1.15379829915964,1.36832642639438
"248"," New Bern"," NC","  South"," RED",-2524,3352,15570,12218,-5909,2182,-8091,-300,200,1510,1310,-491,20,-511,"New Bern, NC (Metropolitan Statistical Area)",4979283000,4807337000,127423,124584,-171946000,0.977719877887038,0.965467718946684
"249"," New Haven"," CT","  Northeast"," BLUE",-7685,10560,81952,71392,-18293,32843,-51136,-2214,625,8512,7887,-2858,2740,-5598,"New Haven-Milford, CT (Metropolitan Statistical Area)",47192971000,48060270000,863357,856971,867299000,0.992603291569999,1.01837771561362
"250"," New Orleans"," LA","  South"," RED",80639,43608,145792,102184,36032,20800,15232,397,2990,15084,12094,-2550,1682,-4232,"New Orleans-Metairie, LA (Metropolitan Statistical Area)",91856971000,74217802000,1195324,1270133,-17639169000,1.06258470506741,0.807971362347666
"251"," New York"," NY","  Northeast"," BLUE",319905,932102,2218113,1286011,-611662,837005,-1448667,-60462,76764,228660,151896,-137415,58630,-196045,"New York-Newark-Jersey City, NY-NJ-PA (Metropolitan Statistical Area)",1346931810000,1532202227000,18923407,19276644,185270417000,1.01866667033056,1.13754996030571
"252"," Niles"," MI","  Midwest"," RED",-3407,733,16572,15839,-4107,3175,-7282,-389,8,1696,1688,-392,216,-608,"Niles, MI (Metropolitan Statistical Area)",6309528000,6877563000,156737,153790,568035000,0.98119780268858,1.09002812888698
"253"," North Port"," FL","  South"," RED",134683,-26920,58378,85298,160197,17686,142511,16279,-4144,6317,10461,20333,1434,18899,"North Port-Sarasota-Bradenton, FL (Metropolitan Statistical Area)",24048098000,30413978000,703354,820716,6365880000,1.16686049983365,1.26471449010229
"254"," Norwich"," CT","  Northeast"," BLUE",-8864,2357,24643,22286,-11261,6111,-17372,-1079,-19,2502,2521,-1059,326,-1385,"Norwich-New London, CT (Metropolitan Statistical Area)",17236944000,17084801000,274004,266285,-152143000,0.971828878410534,0.991173435383906
"255"," Ocala"," FL","  South"," RED",34280,-12786,31649,44435,46967,4122,42845,6517,-1667,3495,5162,8151,15,8136,"Ocala, FL (Metropolitan Statistical Area)",8051095000,9237866000,331331,359062,1186771000,1.08369576043292,1.14740491821299
"256"," Ocean City"," NJ","  Northeast"," BLUE",-5218,-4081,7966,12047,-1037,1060,-2097,-407,-565,734,1299,166,-15,181,"Ocean City, NJ (Metropolitan Statistical Area)",4876428000,4852632000,97212,92446,-23796000,0.950973130889191,0.995120198637199
"257"," Odessa"," TX","  South"," RED",29087,15113,26048,10935,13561,2296,11265,4263,1687,2915,1228,2562,238,2324,"Odessa, TX (Metropolitan Statistical Area)",9303648000,12844718000,137075,161960,3541070000,1.18154295093927,1.38061091735199
"258"," Ogden"," UT","  West"," RED",86702,63341,98076,34735,23625,4772,18853,10204,6365,10133,3768,3835,433,3402,"Ogden-Clearfield, UT (Metropolitan Statistical Area)",21256431000,25916920000,599740,673660,4660489000,1.12325340981092,1.21925077638857
"259"," Oklahoma City"," OK","  South"," RED",155948,65613,171439,105826,89914,24684,65230,15345,5539,17576,12037,9812,1778,8034,"Oklahoma City, OK (Metropolitan Statistical Area)",60373981000,79667931000,1257793,1393605,19293950000,1.107976431734,1.31957392374043
"260"," Olympia"," WA","  West"," BLUE",38276,9076,28792,19716,29233,4982,24251,4480,758,3135,2377,3713,362,3351,"Olympia-Lacey-Tumwater, WA (Metropolitan Statistical Area)",10330905000,12398258000,253001,286056,2067353000,1.13065165750333,1.20011344601465
"261"," Omaha"," NE","  Midwest"," RED",84095,60276,122306,62030,24322,16785,7537,8472,5917,12848,6931,2585,1517,1068,"Omaha-Council Bluffs, NE-IA (Metropolitan Statistical Area)",48022260000,56187854000,867671,940970,8165594000,1.08447787237328,1.17003768668946
"262"," Orlando"," FL","  South"," RED",473748,103875,259676,155801,368588,181996,186592,33309,10064,29522,19458,23227,9517,13710,"Orlando-Kissimmee-Sanford, FL (Metropolitan Statistical Area)",96239638000,124173982000,2139161,2574838,27934344000,1.20366723215317,1.29025819901775
"263"," Oshkosh"," WI","  Midwest"," RED",4907,3727,17264,13537,1311,1101,210,1029,286,1783,1497,748,65,683,"Oshkosh-Neenah, WI (Metropolitan Statistical Area)",8772064000,9274302000,167073,170878,502238000,1.02277447582793,1.0572542562389
"264"," Owensboro"," KY","  South"," RED",4694,2968,14338,11370,1824,1091,733,561,282,1516,1234,283,42,241,"Owensboro, KY (Metropolitan Statistical Area)",5037880000,5222498000,114770,118879,184618000,1.03580203886033,1.03664597013029
"265"," Oxnard"," CA","  West"," BLUE",22608,41771,93266,51495,-18720,7250,-25970,-2136,2920,9161,6241,-5053,140,-5193,"Oxnard-Thousand Oaks-Ventura, CA (Metropolitan Statistical Area)",47693529000,53439240000,825097,848142,5745711000,1.02793004943661,1.12047150044192
"266"," Palm Bay"," FL","  South"," RED",58570,-15771,47809,63580,74263,9438,64825,6739,-2210,5258,7468,8938,429,8509,"Palm Bay-Melbourne-Titusville, FL (Metropolitan Statistical Area)",20512115000,23437467000,543965,595203,2925352000,1.09419356024744,1.14261581509269
"267"," Panama City"," FL","  South"," RED",5855,3934,20996,17062,1770,3938,-2168,-11535,233,2222,1989,-11803,277,-12080,"Panama City, FL (Metropolitan Statistical Area)",7175205000,7606775000,169206,186240,431570000,1.10067018900039,1.06014741042242
"268"," Parkersburg"," WV","  South"," RED",-3328,-1046,9349,10395,-2196,-122,-2074,-652,-216,916,1132,-437,-24,-413,"Parkersburg-Vienna, WV (Metropolitan Statistical Area)",3634579000,3408239000,92698,89991,-226340000,0.970797643962114,0.937725937446951
"269"," Pensacola"," FL","  South"," RED",53638,10215,53258,43043,43221,6040,37181,8230,547,5775,5228,7649,136,7513,"Pensacola-Ferry Pass-Brent, FL (Metropolitan Statistical Area)",16050481000,17968560000,450946,494399,1918079000,1.09635965281874,1.11950289838666
"270"," Peoria"," IL","  Midwest"," BLUE",-15692,7578,47244,39666,-23246,3815,-27061,-2767,382,4733,4351,-3149,339,-3488,"Peoria, IL (Metropolitan Statistical Area)",22787199000,22889895000,416051,403328,102696000,0.96941961442227,1.00450674082409
"271"," Philadelphia"," PA","  Northeast"," RED",136757,155315,658315,503000,-14959,156632,-171591,11226,10873,68207,57334,675,10719,-10044,"Philadelphia-Camden-Wilmington, PA-NJ-DE-MD (Metropolitan Statistical Area)",355280273000,398674377000,5970899,6091208,43394104000,1.02014922710969,1.12214048259302
"272"," Phoenix"," AZ","  West"," RED",755074,247209,540924,293715,505500,106785,398715,98994,20937,57290,36353,77664,6007,71657,"Phoenix-Mesa-Chandler, AZ (Metropolitan Statistical Area)",181027408000,227741337000,4204204,4849209,46713929000,1.15341905388035,1.25804893035866
"273"," Pine Bluff"," AR","  South"," RED",-12485,188,10145,9957,-12826,182,-13008,-1442,-98,963,1061,-1346,6,-1352,"Pine Bluff, AR (Metropolitan Statistical Area)",3716342000,3345604000,100107,89246,-370738000,0.891506088485321,0.90024115111042
"274"," Pittsburgh"," PA","  Northeast"," RED",-38694,-35527,218159,253686,-1150,30654,-31804,-5053,-4817,22570,27387,-103,2555,-2658,"Pittsburgh, PA (Metropolitan Statistical Area)",120154459000,138410497000,2357090,2322653,18256038000,0.98539003601899,1.15193808163208
"275"," Pittsfield"," MA","  Northeast"," BLUE",-6330,-3812,9885,13697,-2447,2422,-4869,-957,-467,993,1460,-487,175,-662,"Pittsfield, MA (Metropolitan Statistical Area)",5999044000,6659360000,131317,125901,660316000,0.958756292026166,1.11007020451925
"276"," Pocatello"," ID","  West"," RED",4828,5945,12890,6945,-1126,1771,-2897,1115,515,1285,770,598,65,533,"Pocatello, ID (Metropolitan Statistical Area)",2953888000,3163717000,90892,94374,209829000,1.03830920213,1.07103485304792
"277"," Portland"," ME","  Northeast"," BLUE",24392,762,45771,45009,23980,6493,17487,3268,-359,4834,5193,3637,463,3174,"Portland-South Portland, ME (Metropolitan Statistical Area)",25104612000,28249782000,513911,535232,3145170000,1.0414877284199,1.12528255764319
"278"," Portland"," OR","  West"," BLUE",266409,96518,253110,156592,169456,47983,121473,19062,7746,26204,18458,11334,2960,8374,"Portland-Vancouver-Hillsboro, OR-WA (Metropolitan Statistical Area)",113249723000,150033141000,2232181,2473350,36783418000,1.1080418657806,1.32479918736755
"279"," Port St. Lucie"," FL","  South"," RED",65190,-6266,39334,45600,71121,8993,62128,8130,-1187,4340,5527,9292,674,8618,"Port St. Lucie, FL (Metropolitan Statistical Area)",13516782000,15258742000,425173,481167,1741960000,1.13169697981763,1.12887386953492
"280"," Poughkeepsie"," NY","  Northeast"," BLUE",8878,22759,69991,47232,-13931,7540,-21471,3093,1978,7627,5649,1154,377,777,"Poughkeepsie-Newburgh-Middletown, NY (Metropolitan Statistical Area)",26255212000,27992552000,671173,676065,1737340000,1.00728873181728,1.06617124249463
"281"," Prescott Valley"," AZ","  West"," RED",24082,-9511,17021,26532,33299,303,32996,3327,-1260,1782,3042,4564,-72,4636,"Prescott Valley-Prescott, AZ (Metropolitan Statistical Area)",5547655000,6481866000,210983,231772,934211000,1.09853400510942,1.16839745802506
"282"," Providence"," RI","  Northeast"," BLUE",23372,13788,152794,139006,10512,49015,-38503,2199,993,16182,15189,1270,4455,-3185,"Providence-Warwick, RI-MA (Metropolitan Statistical Area)",72665966000,77516675000,1603125,1622379,4850709000,1.01201029239766,1.0667535197977
"283"," Provo"," UT","  West"," RED",121367,90108,112018,21910,31402,7531,23871,15103,9594,12092,2498,5473,973,4500,"Provo-Orem, UT (Metropolitan Statistical Area)",16573753000,24664624000,530262,633149,8090871000,1.19403049813111,1.48817374073331
"284"," Pueblo"," CO","  West"," BLUE",9361,1417,17214,15797,8038,458,7580,1002,-26,1808,1834,1033,65,968,"Pueblo, CO (Metropolitan Statistical Area)",5274674000,6084945000,159390,167422,810271000,1.05039211995734,1.15361537035275
"285"," Punta Gorda"," FL","  South"," RED",28943,-13671,9494,23165,42167,2281,39886,4061,-1794,1047,2841,5834,160,5674,"Punta Gorda, FL (Metropolitan Statistical Area)",3894681000,4670656000,159875,184849,775975000,1.15620953870211,1.19923968099056
"286"," Racine"," WI","  Midwest"," RED",883,5764,21964,16200,-4815,747,-5562,-46,593,2257,1664,-637,-4,-633,"Racine, WI (Metropolitan Statistical Area)",8280083000,8450197000,195406,196357,170114000,1.00486679017021,1.02054496313624
"287"," Raleigh"," NC","  South"," RED",260292,78009,144250,66241,180756,34019,146737,29195,7260,15730,8470,21865,3389,18476,"Raleigh-Cary, NC (Metropolitan Statistical Area)",55357585000,76127645000,1137383,1361590,20770060000,1.19712533069335,1.37519808712754
"288"," Rapid City"," SD","  Midwest"," RED",15707,7137,16847,9710,8515,1048,7467,1953,625,1752,1127,1318,-22,1340,"Rapid City, SD (Metropolitan Statistical Area)",4984398000,5848877000,126727,140154,864479000,1.10595216488988,1.17343699279231
"289"," Reading"," PA","  Northeast"," RED",9594,8976,44567,35591,764,13606,-12842,635,823,4708,3885,-177,694,-871,"Reading, PA (Metropolitan Statistical Area)",16248607000,18443415000,412039,420529,2194808000,1.02060484565781,1.13507668688153
"290"," Redding"," CA","  West"," BLUE",2859,-1229,19093,20322,4297,1965,2332,371,-320,1977,2297,707,193,514,"Redding, CA (Metropolitan Statistical Area)",6778074000,7655080000,177274,179709,877006000,1.01373579881991,1.12938867294751
"291"," Reno"," NV","  West"," BLUE",50200,14812,49609,34797,35266,-307,35573,7307,1217,5270,4053,6045,-391,6436,"Reno, NV (Metropolitan Statistical Area)",21493955000,24441835000,425951,468335,2947880000,1.09950440308862,1.13714925894281
"292"," Richmond"," VA","  South"," BLUE",105429,39426,135249,95823,66135,27868,38267,10847,3607,14752,11145,7285,1641,5644,"Richmond, VA (Metropolitan Statistical Area) *",66830500000,75517193000,1188246,1281053,8686693000,1.07810419727901,1.12998096677415
"293"," Riverside"," CA","  West"," BLUE",425683,289072,560691,271619,138230,26965,111265,38089,25452,58823,33371,12721,465,12256,"Riverside-San Bernardino-Ontario, CA (Metropolitan Statistical Area)",128214518000,164892302000,4242424,4612542,36677784000,1.08724210498526,1.28606576362905
"294"," Roanoke"," VA","  South"," BLUE",4556,-2224,30071,32295,6997,5798,1199,189,-670,3040,3710,883,349,534,"Roanoke, VA (Metropolitan Statistical Area) *",14679161000,15119632000,308589,313033,440471000,1.0144010317931,1.03000655146435
"295"," Rochester"," MN","  Midwest"," BLUE",15033,12126,26680,14554,3014,5386,-2372,2107,1142,2813,1671,969,449,520,"Rochester, MN (Metropolitan Statistical Area)",10627736000,12681156000,207222,219814,2053420000,1.06076574881045,1.19321330526088
"296"," Rochester"," NY","  Northeast"," BLUE",-10060,16070,105986,89916,-25978,20870,-46848,-1977,983,10865,9882,-2947,885,-3832,"Rochester, NY (Metropolitan Statistical Area)",54613702000,56811269000,1079974,1071621,2197567000,0.992265554541128,1.04023838193573
"297"," Rockford"," IL","  Midwest"," BLUE",-13315,8421,38636,30215,-21938,3511,-25449,-994,664,4009,3345,-1660,331,-1991,"Rockford, IL (Metropolitan Statistical Area)",13939544000,14788731000,349184,337110,849187000,0.965422241568915,1.06091928114722
"298"," Rocky Mount"," NC","  South"," RED",-6598,580,15786,15206,-7205,380,-7585,-308,-25,1650,1675,-278,47,-325,"Rocky Mount, NC (Metropolitan Statistical Area)",6259993000,9010568000,152405,146078,2750575000,0.958485613989042,1.43938946896586
"299"," Rome"," GA","  South"," RED",2184,1210,10991,9781,1035,1375,-340,534,-7,1133,1140,543,152,391,"Rome, GA (Metropolitan Statistical Area)",3820200000,3787411000,96431,97964,-32789000,1.01589737739938,0.991416941521386
"300"," Sacramento"," CA","  West"," BLUE",214580,94910,252144,157234,120948,51225,69723,21790,7819,26752,18933,13994,4053,9941,"Sacramento-Roseville-Folsom, CA (Metropolitan Statistical Area)",101326243000,128649231000,2153613,2341940,27322988000,1.08744700185224,1.26965361777008
"301"," Saginaw"," MI","  Midwest"," RED",-9630,1529,20833,19304,-11236,1809,-13045,-252,50,2188,2138,-296,125,-421,"Saginaw, MI (Metropolitan Statistical Area)",7314474000,8120484000,199862,190791,806010000,0.954613683441575,1.11019384305693
"302"," St. Cloud"," MN","  Midwest"," BLUE",12871,11239,23588,12349,1686,5396,-3710,1798,1203,2577,1374,602,606,-4,"St. Cloud, MN (Metropolitan Statistical Area)",8315338000,9522149000,189218,200166,1206811000,1.05785918887209,1.14513072108434
"303"," St. George"," UT","  West"," RED",39441,9223,20632,11409,29998,100,29898,5989,876,2244,1368,5085,57,5028,"St. George, UT (Metropolitan Statistical Area)",3484777000,5347692000,138389,171567,1862915000,1.23974448836251,1.5345865746933
"304"," St. Joseph"," MO","  Midwest"," RED",-2096,1972,14117,12145,-4042,1720,-5762,-775,186,1425,1239,-959,157,-1116,"St. Joseph, MO-KS (Metropolitan Statistical Area)",5108954000,5108174000,127271,125998,-780000,0.989997721397648,0.999847326869649
"305"," St. Louis"," MO","  Midwest"," RED",15477,68389,310273,241884,-52131,32872,-85003,-730,4017,31686,27669,-4694,2991,-7685,"St. Louis, MO-IL (Metropolitan Statistical Area)",145227408000,152060042000,2789989,2803958,6832634000,1.00500682977603,1.04704782722556
"306"," Salem"," OR","  West"," BLUE",43165,17354,48852,31498,26003,2479,23524,3499,1662,5258,3596,1840,73,1767,"Salem, OR (Metropolitan Statistical Area)",13231271000,16156484000,391479,430404,2925213000,1.09943062079958,1.2210832957771
"307"," Salinas"," CA","  West"," BLUE",19002,35696,58879,23183,-16579,3403,-19982,111,3055,5797,2742,-2940,-90,-2850,"Salinas, CA (Metropolitan Statistical Area)",21857216000,25834713000,416373,433950,3977497000,1.04221455281683,1.1819763779614
"308"," Salisbury"," MD","  South"," BLUE",41972,-505,38714,39219,42177,4614,37563,5727,-629,4170,4799,6327,162,6165,"Salisbury, MD-DE (Metropolitan Statistical Area)",16222567000,22168321000,374821,409999,5945754000,1.09385279906942,1.36651129257164
"309"," Salt Lake City"," UT","  West"," RED",144888,109213,171087,61874,36389,31265,5124,14015,10461,17555,7094,3586,3667,-81,"Salt Lake City, UT (Metropolitan Statistical Area)",64539182000,82431896000,1091478,1218681,17892714000,1.11654197336089,1.27723800403916
"310"," San Angelo"," TX","  South"," RED",9059,4943,14767,9824,4081,492,3589,1193,425,1525,1100,766,-46,812,"San Angelo, TX (Metropolitan Statistical Area)",5169585000,7555272000,113422,120834,2385687000,1.06534887411613,1.4614852062593
"311"," San Antonio"," TX","  South"," RED",408440,146693,300032,153339,259857,45348,214509,38581,14041,32592,18551,24491,2504,21987,"San Antonio-New Braunfels, TX (Metropolitan Statistical Area)",85678543000,121139794000,2153009,2512379,35461251000,1.16691523351737,1.41388718526644
"312"," San Diego"," CA","  West"," BLUE",242981,204933,398611,193678,40821,107098,-66277,4469,17551,40603,23052,-12998,6733,-19731,"San Diego-Chula Vista-Carlsbad, CA (Metropolitan Statistical Area)",174052646000,219361505000,3103212,3333861,45308859000,1.07432589201125,1.26031697903633
"313"," San Francisco"," CA","  West"," BLUE",396210,202172,477380,275208,194735,231599,-36864,5489,17174,50140,32966,-11590,19996,-31586,"San Francisco-Oakland-Berkeley, CA (Metropolitan Statistical Area)",337823829000,497195398000,4343634,4726314,159371569000,1.08810134555536,1.47175940629102
"314"," San Jose"," CA","  West"," BLUE",153709,126304,220891,94587,28415,152520,-124105,-3144,10905,22487,11582,-14124,13371,-27495,"San Jose-Sunnyvale-Santa Clara, CA (Metropolitan Statistical Area)",174393890000,318998478000,1841556,1993804,144604588000,1.08267356518075,1.82918379766631
"315"," San Luis Obispo"," CA","  West"," BLUE",13514,2358,24056,21698,11234,925,10309,-243,23,2488,2465,-252,-7,-245,"San Luis Obispo-Paso Robles, CA (Metropolitan Statistical Area)",13097558000,16536404000,269802,283354,3438846000,1.0502294275061,1.26255627194016
"316"," Santa Cruz"," CA","  West"," BLUE",10863,10582,26748,16166,384,1760,-1376,-628,655,2540,1885,-1280,59,-1339,"Santa Cruz-Watsonville, CA (Metropolitan Statistical Area)",12268336000,13765700000,263147,273841,1497364000,1.04063888244973,1.1220511078275
"317"," Santa Fe"," NM","  West"," BLUE",6126,1686,12092,10406,4578,2090,2488,597,-2,1189,1191,605,63,542,"Santa Fe, NM (Metropolitan Statistical Area)",6063876000,5825345000,144522,149761,-238531000,1.03625053625054,0.960663608556639
"318"," Santa Maria"," CA","  West"," BLUE",22552,23723,52100,28377,-925,9058,-9983,719,2102,5390,3288,-1371,553,-1924,"Santa Maria-Santa Barbara, CA (Metropolitan Statistical Area)",22583327000,27855958000,424231,445780,5272631000,1.05079543927719,1.2334745009006
"319"," Santa Rosa"," CA","  West"," BLUE",10475,8237,45881,37644,2497,3206,-709,-4307,130,4509,4379,-4437,97,-4534,"Santa Rosa-Petaluma, CA (Metropolitan Statistical Area)",22175649000,28565621000,484755,498643,6389972000,1.02864952398634,1.28815264888076
"320"," Savannah"," GA","  South"," RED",45756,19377,47201,27824,26251,6261,19990,3900,1579,4885,3306,2345,331,2014,"Savannah, GA (Metropolitan Statistical Area)",15527469000,19444860000,348640,389453,3917391000,1.11706344653511,1.25228780041358
"321"," Scranton-"," PA","  Northeast"," RED",-9719,-12308,52222,64530,3012,14117,-11105,-1330,-1267,5537,6804,-40,1130,-1170,"Scranton--Wilkes-Barre, PA (Metropolitan Statistical Area)",23391205000,26081343000,563740,555215,2690138000,0.984877780537127,1.11500638808475
"322"," Seattle"," WA","  West"," BLUE",540037,201727,426466,224739,338123,198637,139486,44666,19628,46679,27051,25048,21247,3801,"Seattle-Tacoma-Bellevue, WA (Metropolitan Statistical Area)",248903638000,355662749000,3449241,3935179,106759111000,1.14088258837234,1.42891743912558
"323"," Sebastian"," FL","  South"," RED",21895,-6260,11703,17963,27992,2343,25649,2736,-894,1283,2177,3612,205,3407,"Sebastian-Vero Beach, FL (Metropolitan Statistical Area)",4438674000,5346831000,138270,157187,908157000,1.1368120344254,1.20460096866767
"324"," Sebring"," FL","  South"," RED",7437,-5745,8302,14047,13232,3261,9971,1288,-773,854,1627,2057,258,1799,"Sebring-Avon Park, FL (Metropolitan Statistical Area)",2426578000,2538660000,98635,104933,112082000,1.06385157398489,1.04618932504951
"325"," Sheboygan"," WI","  Midwest"," RED",-172,1572,11653,10081,-1697,754,-2451,107,147,1226,1079,-35,41,-76,"Sheboygan, WI (Metropolitan Statistical Area)",5833112000,6700198000,115524,115233,867086000,0.997481042900177,1.14864895445176
"326"," Sherman"," TX","  South"," RED",15335,1360,14334,12974,14009,1313,12696,2425,136,1630,1494,2283,90,2193,"Sherman-Denison, TX (Metropolitan Statistical Area)",3833752000,4691343000,121034,133787,857591000,1.10536708693425,1.22369495992438
"327"," Shreveport"," LA","  South"," RED",-3900,14744,52173,37429,-18770,2461,-21231,-2575,770,4920,4150,-3344,57,-3401,"Shreveport-Bossier City, LA (Metropolitan Statistical Area)",21413817000,22611316000,399935,397281,1197499000,0.993363921637266,1.05592179105668
"328"," Sierra Vista"," AZ","  West"," RED",-5437,2604,14452,11848,-8272,2499,-10771,-489,36,1348,1312,-529,66,-595,"Sierra Vista-Douglas, AZ (Metropolitan Statistical Area)",4683595000,4404134000,131822,126411,-279461000,0.958952223452838,0.94033194586637
"329"," Sioux City"," IA","  Midwest"," RED",1119,7700,19546,11846,-6632,2085,-8717,914,816,2012,1196,105,122,-17,"Sioux City, IA-NE-SD (Metropolitan Statistical Area)",7881926000,7629653000,143901,143787,-252273000,0.999207788688056,0.967993482811181
"330"," Sioux Falls"," SD","  Midwest"," RED",39968,19508,35744,16236,20333,6431,13902,4422,2108,3931,1823,2307,260,2047,"Sioux Falls, SD (Metropolitan Statistical Area)",14720192000,17273286000,229099,263810,2553094000,1.15151091886041,1.17344162358752
"331"," South Bend"," IN","  Midwest"," RED",4410,8202,36905,28703,-3668,5192,-8860,916,936,3925,2989,-13,797,-810,"South Bend-Mishawaka, IN-MI (Metropolitan Statistical Area)",12272764000,13576257000,319044,322697,1303493000,1.01144983137122,1.10621022289681
"332"," Spartanburg"," SC","  South"," RED",35481,6361,33877,27516,29139,1679,27460,5648,719,3897,3178,4914,242,4672,"Spartanburg, SC (Metropolitan Statistical Area)",11341453000,13481467000,284731,314137,2140014000,1.10327642581946,1.1886895797214
"333"," Spokane"," WA","  West"," BLUE",53769,14182,59155,44973,39814,6035,33779,9694,1027,6314,5287,8637,486,8151,"Spokane-Spokane Valley, WA (Metropolitan Statistical Area)",20899150000,24586426000,515553,558827,3687276000,1.08393705399833,1.17643186445382
"334"," Springfield"," IL","  Midwest"," BLUE",-3302,3309,22393,19084,-6530,2178,-8708,-1060,95,2323,2228,-1158,199,-1357,"Springfield, IL (Metropolitan Statistical Area)",10340728000,10860798000,210465,207928,520070000,0.987945739196541,1.0502933642583
"335"," Springfield"," MA","  Northeast"," BLUE",4323,4448,63385,58937,-85,30334,-30419,-2756,-71,6474,6545,-2685,959,-3644,"Springfield, MA (Metropolitan Statistical Area)",27622742000,30643846000,694935,700138,3021104000,1.00748703116119,1.10937017041972
"336"," Springfield"," MO","  Midwest"," RED",33544,13234,52176,38942,20399,2408,17991,4027,1068,5478,4410,2957,220,2737,"Springfield, MO (Metropolitan Statistical Area)",16149091000,18040656000,437349,466273,1891565000,1.06613482596279,1.11713136052054
"337"," Springfield"," OH","  Midwest"," RED",-4256,-1117,14729,15846,-3061,459,-3520,-445,-107,1554,1661,-332,23,-355,"Springfield, OH (Metropolitan Statistical Area)",4074170000,4414081000,138274,134528,339911000,0.972908862114353,1.08343073558541
"338"," State College"," PA","  Northeast"," RED",8380,2310,11320,9010,6069,9416,-3347,-216,42,1147,1105,-266,835,-1101,"State College, PA (Metropolitan Statistical Area)",6903491000,7929168000,154230,162601,1025677000,1.05427608117746,1.14857367091519
"339"," Staunton"," VA","  South"," BLUE",4624,-682,11545,12227,5343,1059,4284,492,-127,1229,1356,623,99,524,"Staunton, VA (Metropolitan Statistical Area) *",4897494000,4902654000,118314,122628,5160000,1.03646229524824,1.00105360006567
"340"," Stockton"," CA","  West"," BLUE",76842,44384,93390,49006,32797,10082,22715,9657,4137,9975,5838,5529,687,4842,"Stockton, CA (Metropolitan Statistical Area)",23232499000,29257580000,687127,752491,6025081000,1.0951265195517,1.25933848097874
"341"," Sumter"," SC","  South"," RED",-1968,3100,16598,13498,-5029,1120,-6149,315,162,1645,1483,161,88,73,"Sumter, SC (Metropolitan Statistical Area)",4049636000,4324516000,142555,140151,274880000,0.983136333345025,1.06787770555181
"342"," Syracuse"," NY","  Northeast"," BLUE",-14031,11737,66531,54794,-25820,13114,-38934,-1688,895,6827,5932,-2588,885,-3473,"Syracuse, NY (Metropolitan Statistical Area)",34004022000,36718553000,663110,650281,2714531000,0.980653285276953,1.07982970367447
"343"," Tallahassee"," FL","  South"," RED",18456,12475,37381,24906,5788,6407,-619,2909,1066,3955,2889,1848,465,1383,"Tallahassee, FL (Metropolitan Statistical Area)",15049378000,16287867000,369345,384318,1238489000,1.04053933314381,1.0822950290703
"344"," Tampa"," FL","  South"," RED",411346,12252,294083,281831,397215,104814,292401,40182,-1691,32154,33845,41798,7171,34627,"Tampa-St. Petersburg-Clearwater, FL (Metropolitan Statistical Area)",118486088000,141904761000,2788366,3154649,23418673000,1.13136116277418,1.19764913666489
"345"," Terre Haute"," IN","  Midwest"," RED",-3407,978,20086,19108,-4333,1587,-5920,-359,39,2079,2040,-396,215,-611,"Terre Haute, IN (Metropolitan Statistical Area)",7110330000,7141790000,189523,186726,31460000,0.985241896761871,1.004424548509
"346"," Texarkana"," TX","  South"," RED",-433,2625,17822,15197,-2981,158,-3139,-586,80,1773,1693,-662,-14,-648,"Texarkana, TX-AR (Metropolitan Statistical Area)",5321746000,5180307000,149332,149347,-141439000,1.00010044732542,0.973422444438348
"347"," The Villages"," FL","  South"," RED",39000,-10573,4311,14884,48895,-134,49029,3701,-1539,478,2017,5212,-57,5269,"The Villages, FL (Metropolitan Statistical Area)",1775497000,2484841000,94278,128719,709344000,1.365313222597,1.39951855733916
"348"," Toledo"," OH","  Midwest"," RED",-9619,12412,71848,59436,-22094,5646,-27740,-1273,804,7428,6624,-2069,270,-2339,"Toledo, OH (Metropolitan Statistical Area)",31341991000,34845826000,651372,643089,3503835000,0.987283764116357,1.11179363174471
"349"," Topeka"," KS","  Midwest"," RED",-1891,4737,26664,21927,-6550,1618,-8168,-297,250,2590,2340,-541,132,-673,"Topeka, KS (Metropolitan Statistical Area)",9511910000,10065715000,234266,232266,553805000,0.99146269625127,1.05822227081627
"350"," Trenton"," NJ","  Northeast"," BLUE",-55,11634,38444,26810,-11831,16366,-28197,-758,1034,4021,2987,-1815,1182,-2997,"Trenton-Princeton, NJ (Metropolitan Statistical Area)",26606523000,28459499000,367713,368188,1852976000,1.00129176830844,1.0696436734706
"351"," Tucson"," AZ","  West"," RED",67016,21542,107047,85505,46336,22079,24257,10725,692,10891,10199,10005,1204,8801,"Tucson, AZ (Metropolitan Statistical Area)",36396420000,40011352000,981620,1036554,3614932000,1.05596259244922,1.09932108707395
"352"," Tulsa"," OK","  South"," RED",61103,35371,121193,85822,26210,14415,11795,5491,2558,12440,9882,2972,1257,1715,"Tulsa, OK (Metropolitan Statistical Area)",42694048000,53448340000,939833,993135,10754292000,1.05671433116309,1.25189206701599
"353"," Tuscaloosa"," AL","  South"," RED",12833,6871,27624,20753,5911,2721,3190,790,541,2922,2381,256,232,24,"Tuscaloosa, AL (Metropolitan Statistical Area)",9851423000,9952170000,239481,251257,100747000,1.04917300328627,1.01022664441472
"354"," Twin Falls"," ID","  West"," RED",11694,6569,14844,8275,5159,2539,2620,1195,632,1562,930,568,158,410,"Twin Falls, ID (Metropolitan Statistical Area)",3602691000,4671994000,99987,110095,1069303000,1.10109314210847,1.29680674806693
"355"," Tyler"," TX","  South"," RED",23026,9252,28191,18939,13822,2131,11691,3002,792,2969,2177,2212,92,2120,"Tyler, TX (Metropolitan Statistical Area)",9296927000,10179462000,210408,229749,882535000,1.09192140983233,1.09492760349737
"356"," Urban Honolulu"," HI","  West"," BLUE",21357,50711,121272,70561,-28785,46111,-74896,-5295,3418,12013,8595,-8691,3736,-12427,"Urban Honolulu, HI (Metropolitan Statistical Area)",53789213000,61095819000,956285,979858,7306606000,1.02465060102375,1.13583775616869
"357"," Utica"," NY","  Northeast"," BLUE",-9339,31,29641,29610,-9340,5250,-14590,-1197,-107,3042,3149,-1090,265,-1355,"Utica-Rome, NY (Metropolitan Statistical Area)",11710696000,11892236000,299226,291187,181540000,0.973134019102618,1.01550206751162
"358"," Valdosta"," GA","  South"," RED",7630,7791,18666,10875,-341,2056,-2397,1149,616,1934,1318,536,127,409,"Valdosta, GA (Metropolitan Statistical Area)",4741080000,5054748000,140054,146143,313668000,1.04347608779471,1.06615960920297
"359"," Vallejo"," CA","  West"," BLUE",34300,18081,47682,29601,16528,6691,9837,1918,1377,5088,3711,557,280,277,"Vallejo, CA (Metropolitan Statistical Area)",18387013000,23303994000,413967,445725,4916981000,1.07671625999174,1.26741597452506
"360"," Victoria"," TX","  South"," RED",5739,4340,12404,8064,1389,546,843,276,350,1247,897,-71,24,-95,"Victoria, TX (Metropolitan Statistical Area)",4481091000,5069679000,94102,99466,588588000,1.05700197657861,1.13134926293619
"361"," Vineland"," NJ","  Northeast"," BLUE",-7100,4541,18338,13797,-11725,3190,-14915,-1108,322,1757,1435,-1435,74,-1509,"Vineland-Bridgeton, NJ (Metropolitan Statistical Area)",5954839000,6051881000,156699,150635,97042000,0.961301603711574,1.01629632639942
"362"," Virginia Beach"," VA","  South"," BLUE",54946,78552,209617,131065,-23410,36319,-59729,5188,6309,21589,15280,-1032,1165,-2197,"Virginia Beach-Norfolk-Newport News, VA-NC (Metropolitan Statistical Area) *",88030767000,89775562000,1717036,1763713,1744795000,1.02718463678106,1.01982028624151
"363"," Visalia"," CA","  West"," BLUE",24013,41985,69462,27477,-17932,-636,-17296,1606,3823,7032,3209,-2230,-270,-1960,"Visalia, CA (Metropolitan Statistical Area)",14190018000,18415098000,442969,464589,4225080000,1.04880702712831,1.29775015084547
"364"," Waco"," TX","  South"," RED",21154,12895,33987,21092,8384,2630,5754,2493,1249,3646,2397,1244,161,1083,"Waco, TX (Metropolitan Statistical Area)",9710032000,12745968000,253808,271427,3035936000,1.06941861564647,1.3126597317084
"365"," Walla Walla"," WA","  West"," BLUE",1979,842,6100,5258,1163,136,1027,145,35,610,575,113,-15,128,"Walla Walla, WA (Metropolitan Statistical Area)",2676299000,3068776000,58915,60615,392477000,1.02885513027243,1.14664915990328
"366"," Warner Robins"," GA","  South"," RED",17783,8835,21567,12732,8970,2828,6142,2523,730,2297,1567,1799,152,1647,"Warner Robins, GA (Metropolitan Statistical Area)",6501259000,6979808000,168508,182886,478549000,1.08532532580056,1.07360866564461
"367"," Washington"," VA"," South"," ",630799,428108,743898,315790,200650,326958,-126308,32646,39384,78147,38763,-6771,22977,-29748,"Washington-Arlington-Alexandria, DC-VA-MD-WV (Metropolitan Statistical Area) *",429589652000,484792706000,5678491,6247841,55203054000,1.10026431317757,1.12850182434096
"368"," Waterloo"," IA","  Midwest"," RED",703,5008,19377,14369,-4194,2815,-7009,-414,491,2055,1564,-899,211,-1110,"Waterloo-Cedar Falls, IA (Metropolitan Statistical Area)",8365341000,8786794000,167920,168936,421453000,1.00605050023821,1.05038085118108
"369"," Watertown"," NY","  Northeast"," BLUE",-6398,10875,19170,8295,-17420,3033,-20453,-2032,994,1913,919,-3026,-45,-2981,"Watertown-Fort Drum, NY (Metropolitan Statistical Area)",6697552000,5910020000,116592,111866,-787532000,0.959465486482778,0.882414948028772
"370"," Wausau"," WI","  Midwest"," RED",481,3423,17162,13739,-2856,612,-3468,191,337,1744,1407,-142,66,-208,"Wausau-Weston, WI (Metropolitan Statistical Area)",7637869000,9107116000,162829,163094,1469247000,1.00162747422142,1.19236347206269
"371"," Weirton"," WV","  South"," RED",-8381,-5260,10356,15616,-3005,-176,-2829,-908,-580,1079,1659,-322,-50,-272,"Weirton-Steubenville, WV-OH (Metropolitan Statistical Area)",5134274000,6036969000,124329,116982,902695000,0.94090678763603,1.17581745734645
"372"," Wenatchee"," WA","  West"," BLUE",9742,4326,13383,9057,5489,666,4823,1128,381,1393,1012,750,48,702,"Wenatchee, WA (Metropolitan Statistical Area)",4799680000,5978089000,111264,119501,1178409000,1.07403113316077,1.24551824288286
"373"," Wheeling"," WV","  South"," RED",-9009,-4101,13249,17350,-4802,-57,-4745,-1111,-545,1285,1830,-560,-27,-533,"Wheeling, WV-OH (Metropolitan Statistical Area)",6443008000,11897160000,147899,140059,5454152000,0.946990851865124,1.84652261800699
"374"," Wichita"," KS","  Midwest"," RED",17157,29769,81503,51734,-12358,9096,-21454,2699,2325,8057,5732,397,688,-291,"Wichita, KS (Metropolitan Statistical Area)",27680811000,32832296000,623887,637519,5151485000,1.02185011067709,1.18610310947898
"375"," Wichita Falls"," TX","  South"," RED",-220,2932,17382,14450,-3110,3283,-6393,299,101,1730,1629,203,167,36,"Wichita Falls, TX (Metropolitan Statistical Area)",5770448000,6078296000,151649,150955,307848000,0.995423642753991,1.0533490640588
"376"," Williamsport"," PA","  Northeast"," RED",-2803,-325,11394,11719,-2439,602,-3041,-567,-187,1133,1320,-379,65,-444,"Williamsport, PA (Metropolitan Statistical Area)",4717326000,6530249000,116225,113866,1812923000,0.979703161970316,1.38431157821189
"377"," Wilmington"," NC","  South"," RED",42654,4489,26461,21972,37745,1521,36224,3260,254,2844,2590,2996,124,2872,"Wilmington, NC (Metropolitan Statistical Area)",11089957000,13438658000,255699,294273,2348701000,1.15085706240541,1.21178630358982
"378"," Winchester"," VA","  South"," BLUE",12114,3266,14270,11004,8878,1826,7052,1074,221,1492,1271,856,75,781,"Winchester, VA-WV (Metropolitan Statistical Area) *",5652676000,5970463000,128652,139492,317787000,1.08425830923732,1.05621885988159
"379"," Winston"," NC","  South"," RED",35505,10063,68473,58410,25813,4664,21149,4879,729,7271,6542,4166,358,3808,"Winston-Salem, NC (Metropolitan Statistical Area)",29430173000,29528114000,641245,671129,97941000,1.04660309242177,1.00332791112033
"380"," Worcester"," MA","  Northeast"," BLUE",30641,16269,90296,74027,14793,36326,-21533,1291,1162,9575,8413,145,2272,-2127,"Worcester, MA-CT (Metropolitan Statistical Area)",39893027000,45393131000,918935,946113,5500104000,1.02957554125156,1.13787131269833
"381"," Yakima"," WA","  West"," BLUE",7633,19134,37137,18003,-11510,-269,-11241,311,1653,3746,2093,-1340,-137,-1203,"Yakima, WA (Metropolitan Statistical Area)",8665802000,9883248000,244256,250562,1217446000,1.02581717542251,1.14048855489659
"382"," York"," PA","  Northeast"," RED",14043,8584,45524,36940,5907,5255,652,1211,747,4868,4121,491,200,291,"York-Hanover, PA (Metropolitan Statistical Area)",18037377000,18675558000,435413,447847,638181000,1.0285567955022,1.03538103128853
"383"," Youngstown"," OH","  Midwest"," RED",-29701,-12813,51745,64558,-16642,2675,-19317,-2145,-1392,5450,6842,-726,25,-751,"Youngstown-Warren-Boardman, OH-PA (Metropolitan Statistical Area)",19634198000,20089962000,564826,538226,455764000,0.952905850651351,1.02321276377064
"384"," Yuba City"," CA","  West"," BLUE",8741,10299,23119,12820,-1566,2723,-4289,1734,999,2416,1417,737,100,637,"Yuba City, CA (Metropolitan Statistical Area)",6191460000,6506948000,167099,173905,315488000,1.04073034548382,1.05095534817313
"385"," Yuma"," AZ","  West"," RED",18037,14964,28472,13508,2839,7552,-4713,2175,1278,2991,1713,903,546,357,"Yuma, AZ (Metropolitan Statistical Area)",6626379000,7874389000,197127,211612,1248010000,1.07348054807307,1.18833966484561
"386"," Aberdeen"," SD","  Midwest"," RED",2065,1199,5041,3842,866,928,-62,-343,143,537,394,-485,21,-506,NA,0,0,0,0,0,NA,NA
"387"," Aberdeen"," WA","  West"," BLUE",2261,-504,7159,7663,2757,51,2706,1260,-152,734,886,1407,-16,1423,NA,0,0,0,0,0,NA,NA
"388"," Ada"," OK","  South"," RED",796,849,4921,4072,-24,397,-421,12,-22,487,509,36,42,-6,NA,0,0,0,0,0,NA,NA
"389"," Adrian"," MI","  Midwest"," RED",-1448,216,9501,9285,-1653,365,-2018,310,-55,952,1007,372,5,367,NA,0,0,0,0,0,NA,NA
"390"," Alamogordo"," NM","  West"," BLUE",3658,2995,8450,5455,585,3739,-3154,831,319,934,615,513,263,250,NA,0,0,0,0,0,NA,NA
"391"," Albemarle"," NC","  South"," RED",2220,-3,6276,6279,2274,172,2102,626,-6,709,715,633,10,623,NA,0,0,0,0,0,NA,NA
"392"," Albert Lea"," MN","  Midwest"," BLUE",-973,-239,3115,3354,-723,228,-951,-199,-38,314,352,-162,25,-187,NA,0,0,0,0,0,NA,NA
"393"," Albertville"," AL","  South"," RED",3755,2099,12326,10227,1750,818,932,604,240,1395,1155,368,65,303,NA,0,0,0,0,0,NA,NA
"394"," Alexander City"," AL","  South"," RED",-2344,-1177,5001,6178,-1149,91,-1240,-148,-182,474,656,39,15,24,NA,0,0,0,0,0,NA,NA
"395"," Alexandria"," MN","  Midwest"," BLUE",2130,78,3848,3770,2080,51,2029,181,-6,424,430,189,2,187,NA,0,0,0,0,0,NA,NA
"396"," Alice"," TX","  South"," RED",-981,2292,7203,4911,-3303,420,-3723,-264,121,652,531,-386,46,-432,NA,0,0,0,0,0,NA,NA
"397"," Alma"," MI","  Midwest"," RED",-1767,-354,3694,4048,-1415,115,-1530,109,-57,366,423,167,7,160,NA,0,0,0,0,0,NA,NA
"398"," Alpena"," MI","  Midwest"," RED",-1189,-912,2494,3406,-250,65,-315,21,-62,280,342,84,8,76,NA,0,0,0,0,0,NA,NA
"399"," Altus"," OK","  South"," RED",-1916,1458,3813,2355,-3412,659,-4071,-245,144,359,215,-389,45,-434,NA,0,0,0,0,0,NA,NA
"400"," Americus"," GA","  South"," RED",-3047,520,4115,3595,-3609,260,-3869,-245,46,423,377,-294,39,-333,NA,0,0,0,0,0,NA,NA
"401"," Amsterdam"," NY","  Northeast"," BLUE",-1043,211,5537,5326,-1243,1067,-2310,-173,80,613,533,-253,14,-267,NA,0,0,0,0,0,NA,NA
"402"," Andrews"," TX","  South"," RED",3919,1488,2782,1294,2381,190,2191,694,97,286,189,597,14,583,NA,0,0,0,0,0,NA,NA
"403"," Angola"," IN","  Midwest"," RED",447,494,3433,2939,-15,83,-98,107,-12,336,348,121,15,106,NA,0,0,0,0,0,NA,NA
"404"," Arcadia"," FL","  South"," RED",3139,567,3546,2979,2581,1484,1097,633,27,389,362,604,154,450,NA,0,0,0,0,0,NA,NA
"405"," Ardmore"," OK","  South"," RED",1219,561,7220,6659,691,242,449,-5,17,743,726,-20,10,-30,NA,0,0,0,0,0,NA,NA
"406"," Arkadelphia"," AR","  South"," RED",-671,-109,2210,2319,-564,100,-664,7,-8,233,241,16,2,14,NA,0,0,0,0,0,NA,NA
"407"," Ashland"," OH","  Midwest"," RED",344,473,5636,5163,-119,759,-878,-222,6,586,580,-229,56,-285,NA,0,0,0,0,0,NA,NA
"408"," Ashtabula"," OH","  Midwest"," RED",-4248,-515,10325,10840,-3730,598,-4328,-346,-32,1111,1143,-313,-6,-307,NA,0,0,0,0,0,NA,NA
"409"," Astoria"," OR","  West"," BLUE",3198,153,3788,3635,3034,107,2927,513,-21,377,398,530,-12,542,NA,0,0,0,0,0,NA,NA
"410"," Atchison"," KS","  Midwest"," RED",-848,143,1809,1666,-996,-15,-981,-100,-8,162,170,-92,-2,-90,NA,0,0,0,0,0,NA,NA
"411"," Athens"," OH","  Midwest"," RED",563,406,4894,4488,52,2277,-2225,-192,-17,477,494,-177,128,-305,NA,0,0,0,0,0,NA,NA
"412"," Athens"," TN","  South"," RED",1507,-827,5308,6135,2373,554,1819,458,-65,591,656,526,73,453,NA,0,0,0,0,0,NA,NA
"413"," Athens"," TX","  South"," RED",4159,-1376,8297,9673,5569,241,5328,634,-211,894,1105,845,9,836,NA,0,0,0,0,0,NA,NA
"414"," Atmore"," AL","  South"," RED",-1687,-234,4108,4342,-1439,-2,-1437,109,-54,420,474,165,-1,166,NA,0,0,0,0,0,NA,NA
"415"," Auburn"," IN","  Midwest"," RED",1220,1104,4850,3746,141,-42,183,267,102,508,406,167,-9,176,NA,0,0,0,0,0,NA,NA
"416"," Auburn"," NY","  Northeast"," BLUE",-3432,184,7159,6975,-3610,458,-4068,-545,30,741,711,-576,26,-602,NA,0,0,0,0,0,NA,NA
"417"," Augusta"," ME","  Northeast"," BLUE",148,-1372,10840,12212,1623,543,1080,258,-277,1113,1390,540,40,500,NA,0,0,0,0,0,NA,NA
"418"," Austin"," MN","  Midwest"," BLUE",895,1151,4726,3575,-236,1171,-1407,-80,165,535,370,-246,126,-372,NA,0,0,0,0,0,NA,NA
"419"," Bainbridge"," GA","  South"," RED",-1438,483,3399,2916,-1929,-59,-1870,-169,30,361,331,-198,-4,-194,NA,0,0,0,0,0,NA,NA
"420"," Baraboo"," WI","  Midwest"," RED",2487,1410,7050,5640,1141,557,584,124,122,728,606,5,19,-14,NA,0,0,0,0,0,NA,NA
"421"," Bardstown"," KY","  South"," RED",2792,1701,5337,3636,1114,-39,1153,420,133,552,419,287,-7,294,NA,0,0,0,0,0,NA,NA
"422"," Barre"," VT","  Northeast"," BLUE",-1115,243,5218,4975,-1334,85,-1419,330,0,534,534,329,-9,338,NA,0,0,0,0,0,NA,NA
"423"," Bartlesville"," OK","  South"," RED",548,65,5824,5759,523,823,-300,-264,-91,586,677,-172,83,-255,NA,0,0,0,0,0,NA,NA
"424"," Batavia"," NY","  Northeast"," BLUE",-2654,-311,5414,5725,-2342,222,-2564,-207,-88,542,630,-118,2,-120,NA,0,0,0,0,0,NA,NA
"425"," Batesville"," AR","  South"," RED",1363,-222,6086,6308,1606,177,1429,209,36,706,670,177,-5,182,NA,0,0,0,0,0,NA,NA
"426"," Bay City"," TX","  South"," RED",-59,1454,4938,3484,-1508,85,-1593,77,149,520,371,-72,7,-79,NA,0,0,0,0,0,NA,NA
"427"," Beatrice"," NE","  Midwest"," RED",-798,-335,2204,2539,-459,-1,-458,18,-27,228,255,47,1,46,NA,0,0,0,0,0,NA,NA
"428"," Beaver Dam"," WI","  Midwest"," RED",-911,-659,7569,8228,-187,225,-412,6,-103,771,874,112,22,90,NA,0,0,0,0,0,NA,NA
"429"," Bedford"," IN","  Midwest"," RED",-759,-660,4446,5106,-52,105,-157,-260,-98,465,563,-159,5,-164,NA,0,0,0,0,0,NA,NA
"430"," Beeville"," TX","  South"," RED",704,1029,3385,2356,-320,32,-352,98,84,318,234,13,-5,18,NA,0,0,0,0,0,NA,NA
"431"," Bellefontaine"," OH","  Midwest"," RED",-176,541,5041,4500,-694,89,-783,340,51,547,496,292,-2,294,NA,0,0,0,0,0,NA,NA
"432"," Bemidji"," MN","  Midwest"," BLUE",2745,2505,6316,3811,267,361,-94,453,205,638,433,248,29,219,NA,0,0,0,0,0,NA,NA
"433"," Bennettsville"," SC","  South"," RED",-2817,-386,2747,3133,-2440,42,-2482,-274,-40,270,310,-233,1,-234,NA,0,0,0,0,0,NA,NA
"434"," Bennington"," VT","  Northeast"," BLUE",-1649,-1029,3103,4132,-601,210,-811,-50,-124,323,447,75,15,60,NA,0,0,0,0,0,NA,NA
"435"," Berlin"," NH","  Northeast"," BLUE",-1489,-1728,2274,4002,187,39,148,77,-194,225,419,272,-2,274,NA,0,0,0,0,0,NA,NA
"436"," Big Rapids"," MI","  Midwest"," RED",655,351,3873,3522,319,430,-111,53,39,396,357,15,19,-4,NA,0,0,0,0,0,NA,NA
"437"," Big Spring"," TX","  South"," RED",1652,660,4210,3550,961,838,123,739,89,438,349,649,81,568,NA,0,0,0,0,0,NA,NA
"438"," Big Stone Gap"," VA","  South"," BLUE",-4066,-809,4176,4985,-3295,107,-3402,-483,-150,375,525,-332,0,-332,NA,0,0,0,0,0,NA,NA
"439"," Blackfoot"," ID","  West"," RED",1206,3146,6429,3283,-1975,131,-2106,682,216,593,377,469,8,461,NA,0,0,0,0,0,NA,NA
"440"," Bluefield"," WV","  South"," RED",-8514,-3521,11117,14638,-4943,105,-5048,-930,-483,1108,1591,-443,-20,-423,NA,0,0,0,0,0,NA,NA
"441"," Blytheville"," AR","  South"," RED",-5830,1199,5904,4705,-7097,-25,-7072,-585,82,580,498,-671,-19,-652,NA,0,0,0,0,0,NA,NA
"442"," Bogalusa"," LA","  South"," RED",-946,86,5489,5403,-1009,-116,-893,-394,-35,600,635,-357,-16,-341,NA,0,0,0,0,0,NA,NA
"443"," Bonham"," TX","  South"," RED",1604,-791,3105,3896,2427,329,2098,329,-116,321,437,446,41,405,NA,0,0,0,0,0,NA,NA
"444"," Boone"," NC","  South"," RED",5116,167,3356,3189,4911,253,4658,143,-20,381,401,164,43,121,NA,0,0,0,0,0,NA,NA
"445"," Borger"," TX","  South"," RED",-1313,470,2677,2207,-1790,82,-1872,-181,41,256,215,-224,2,-226,NA,0,0,0,0,0,NA,NA
"446"," Bozeman"," MT","  West"," RED",24919,5836,10887,5051,18837,1465,17372,2752,650,1262,612,2084,111,1973,NA,0,0,0,0,0,NA,NA
"447"," Bradford"," PA","  Northeast"," RED",-2836,-936,3863,4799,-1881,67,-1948,-325,-140,367,507,-184,1,-185,NA,0,0,0,0,0,NA,NA
"448"," Brainerd"," MN","  Midwest"," BLUE",3757,524,9523,8999,3298,251,3047,529,-84,932,1016,611,13,598,NA,0,0,0,0,0,NA,NA
"449"," Branson"," MO","  Midwest"," RED",4256,677,5806,5129,3587,238,3349,209,60,615,555,152,7,145,NA,0,0,0,0,0,NA,NA
"450"," Breckenridge"," CO","  West"," BLUE",3017,2028,2591,563,951,1029,-78,194,197,266,69,-4,101,-105,NA,0,0,0,0,0,NA,NA
"451"," Brenham"," TX","  South"," RED",2183,197,3691,3494,1999,285,1714,386,-19,364,383,407,-2,409,NA,0,0,0,0,0,NA,NA
"452"," Brevard"," NC","  South"," RED",1296,-1267,2460,3727,2570,-12,2582,212,-133,261,394,346,-3,349,NA,0,0,0,0,0,NA,NA
"453"," Brookhaven"," MS","  South"," RED",-713,266,4065,3799,-960,80,-1040,-57,10,413,403,-65,6,-71,NA,0,0,0,0,0,NA,NA
"454"," Brookings"," OR","  West"," BLUE",561,-1759,1631,3390,2311,-188,2499,130,-179,166,345,308,-24,332,NA,0,0,0,0,0,NA,NA
"455"," Brookings"," SD","  Midwest"," RED",3111,2093,3890,1797,1021,1407,-386,0,239,443,204,-241,69,-310,NA,0,0,0,0,0,NA,NA
"456"," Brownsville"," TN","  South"," RED",-1503,87,1951,1864,-1598,19,-1617,-43,-44,189,233,1,-1,2,NA,0,0,0,0,0,NA,NA
"457"," Brownwood"," TX","  South"," RED",-242,-684,3809,4493,469,211,258,44,-58,382,440,104,13,91,NA,0,0,0,0,0,NA,NA
"458"," Bucyrus"," OH","  Midwest"," RED",-2289,-614,4390,5004,-1664,144,-1808,10,-43,455,498,54,13,41,NA,0,0,0,0,0,NA,NA
"459"," Burley"," ID","  West"," RED",2050,3090,6509,3419,-1047,379,-1426,559,335,699,364,225,6,219,NA,0,0,0,0,0,NA,NA
"460"," Burlington"," IA","  Midwest"," RED",-2040,-210,4823,5033,-1820,169,-1989,-233,-29,500,529,-202,-11,-191,NA,0,0,0,0,0,NA,NA
"461"," Butte"," MT","  West"," RED",706,-233,3603,3836,960,673,287,176,-55,364,419,232,51,181,NA,0,0,0,0,0,NA,NA
"462"," Cadillac"," MI","  Midwest"," RED",1163,575,5336,4761,613,182,431,202,50,551,501,153,11,142,NA,0,0,0,0,0,NA,NA
"463"," Calhoun"," GA","  South"," RED",2742,1712,6410,4698,1061,327,734,335,98,669,571,240,23,217,NA,0,0,0,0,0,NA,NA
"464"," Cambridge"," MD","  South"," BLUE",-694,-125,3420,3545,-548,332,-880,-31,-55,340,395,27,8,19,NA,0,0,0,0,0,NA,NA
"465"," Cambridge"," OH","  Midwest"," RED",-1217,-36,4201,4237,-1158,53,-1211,-136,-36,426,462,-98,-1,-97,NA,0,0,0,0,0,NA,NA
"466"," Camden"," AR","  South"," RED",-2925,-818,3027,3845,-2113,38,-2151,-276,-98,288,386,-176,-1,-175,NA,0,0,0,0,0,NA,NA
"467"," Campbellsville"," KY","  South"," RED",944,106,4101,3995,838,331,507,198,-8,431,439,208,7,201,NA,0,0,0,0,0,NA,NA
"468"," on City"," CO","  West"," BLUE",1011,-1565,3471,5036,2558,108,2450,-120,-183,381,564,65,-5,70,NA,0,0,0,0,0,NA,NA
"469"," Carlsbad"," NM","  West"," BLUE",4632,2483,7638,5155,2121,569,1552,731,255,805,550,475,47,428,NA,0,0,0,0,0,NA,NA
"470"," Carroll"," IA","  Midwest"," RED",-651,148,2376,2228,-801,59,-860,12,13,237,224,-1,7,-8,NA,0,0,0,0,0,NA,NA
"471"," Cedar City"," UT","  West"," RED",8676,4979,7802,2823,3667,-130,3797,2161,507,830,323,1645,-30,1675,NA,0,0,0,0,0,NA,NA
"472"," Cedartown"," GA","  South"," RED",1118,847,5233,4386,276,164,112,267,91,580,489,176,-5,181,NA,0,0,0,0,0,NA,NA
"473"," Celina"," OH","  Midwest"," RED",356,1615,5384,3769,-1250,104,-1354,220,259,644,385,-37,7,-44,NA,0,0,0,0,0,NA,NA
"474"," Central City"," KY","  South"," RED",-877,-318,3199,3517,-550,-13,-537,-189,-54,340,394,-135,-2,-133,NA,0,0,0,0,0,NA,NA
"475"," Centralia"," IL","  Midwest"," BLUE",-2232,-316,4502,4818,-1907,118,-2025,-176,-10,451,461,-166,10,-176,NA,0,0,0,0,0,NA,NA
"476"," Centralia"," WA","  West"," BLUE",5250,292,8271,7979,4965,589,4376,1138,-15,895,910,1152,65,1087,NA,0,0,0,0,0,NA,NA
"477"," Charleston"," IL","  Midwest"," BLUE",-3534,-14,5745,5759,-3543,568,-4111,-246,-38,571,609,-207,51,-258,NA,0,0,0,0,0,NA,NA
"478"," Chillicothe"," OH","  Midwest"," RED",-1410,130,7792,7662,-1504,166,-1670,-218,-5,844,849,-211,9,-220,NA,0,0,0,0,0,NA,NA
"479"," Clarksburg"," WV","  South"," RED",-1787,-1300,9279,10579,-434,6,-440,-479,-277,887,1164,-195,-10,-185,NA,0,0,0,0,0,NA,NA
"480"," Clarksdale"," MS","  South"," RED",-4021,1015,3790,2775,-5081,-31,-5050,-481,73,355,282,-555,-7,-548,NA,0,0,0,0,0,NA,NA
"481"," Clearlake"," CA","  West"," BLUE",-276,-969,6824,7793,732,-169,901,69,-117,731,848,189,-26,215,NA,0,0,0,0,0,NA,NA
"482"," Cleveland"," MS","  South"," RED",-3525,750,4522,3772,-4289,119,-4408,-487,7,405,398,-496,23,-519,NA,0,0,0,0,0,NA,NA
"483"," Clewiston"," FL","  South"," RED",2879,2722,5440,2718,50,2939,-2889,686,220,576,356,467,341,126,NA,0,0,0,0,0,NA,NA
"484"," Clinton"," IA","  Midwest"," RED",-2688,67,5191,5124,-2772,245,-3017,-8,-10,508,518,3,12,-9,NA,0,0,0,0,0,NA,NA
"485"," Clovis"," NM","  West"," BLUE",578,4661,8269,3608,-4153,1307,-5460,-384,446,824,378,-829,-8,-821,NA,0,0,0,0,0,NA,NA
"486"," Coffeyville"," KS","  Midwest"," RED",-3639,-182,3828,4010,-3488,564,-4052,-262,-34,322,356,-229,61,-290,NA,0,0,0,0,0,NA,NA
"487"," Coldwater"," MI","  Midwest"," RED",-1725,807,4885,4078,-2535,421,-2956,-49,96,515,419,-143,29,-172,NA,0,0,0,0,0,NA,NA
"488"," Columbus"," MS","  South"," RED",-1184,1716,7305,5589,-2886,912,-3798,-165,164,774,610,-328,89,-417,NA,0,0,0,0,0,NA,NA
"489"," Columbus"," NE","  Midwest"," RED",1233,1870,4436,2566,-635,597,-1232,183,180,461,281,4,73,-69,NA,0,0,0,0,0,NA,NA
"490"," Concord"," NH","  Northeast"," BLUE",4940,-43,12391,12434,5104,3462,1642,741,-83,1305,1388,830,279,551,NA,0,0,0,0,0,NA,NA
"491"," Connersville"," IN","  Midwest"," RED",-1199,-601,2303,2904,-586,76,-662,26,-14,271,285,42,15,27,NA,0,0,0,0,0,NA,NA
"492"," Cookeville"," TN","  South"," RED",8217,-82,11278,11360,8336,1988,6348,1796,-52,1206,1258,1846,210,1636,NA,0,0,0,0,0,NA,NA
"493"," Coos Bay"," OR","  West"," BLUE",1432,-2564,5693,8257,4023,122,3901,215,-338,599,937,553,-15,568,NA,0,0,0,0,0,NA,NA
"494"," Cordele"," GA","  South"," RED",-1061,402,2705,2303,-1488,141,-1629,-245,-33,256,289,-213,11,-224,NA,0,0,0,0,0,NA,NA
"495"," Corinth"," MS","  South"," RED",-109,-217,4017,4234,140,27,113,143,-46,411,457,190,-7,197,NA,0,0,0,0,0,NA,NA
"496"," Cornelia"," GA","  South"," RED",2296,718,4729,4011,1572,96,1476,-45,88,537,449,-132,2,-134,NA,0,0,0,0,0,NA,NA
"497"," Corning"," NY","  Northeast"," BLUE",-3603,719,9839,9120,-4306,535,-4841,-481,-41,981,1022,-440,49,-489,NA,0,0,0,0,0,NA,NA
"498"," Corsicana"," TX","  South"," RED",2273,1583,6400,4817,714,133,581,577,141,678,537,437,9,428,NA,0,0,0,0,0,NA,NA
"499"," Cortland"," NY","  Northeast"," BLUE",-1709,323,4403,4080,-2037,212,-2249,-141,50,472,422,-191,19,-210,NA,0,0,0,0,0,NA,NA
"500"," Coshocton"," OH","  Midwest"," RED",-300,512,4217,3705,-796,61,-857,4,52,460,408,-46,4,-50,NA,0,0,0,0,0,NA,NA
"501"," Craig"," CO","  West"," BLUE",-508,771,1659,888,-1302,86,-1388,100,89,170,81,11,19,-8,NA,0,0,0,0,0,NA,NA
"502"," Crawfordsville"," IN","  Midwest"," RED",217,569,4195,3626,-328,191,-519,64,37,426,389,29,44,-15,NA,0,0,0,0,0,NA,NA
"503"," Crescent City"," CA","  West"," BLUE",-798,146,2810,2664,-982,103,-1085,72,6,261,255,68,15,53,NA,0,0,0,0,0,NA,NA
"504"," Crossville"," TN","  South"," RED",4460,-2362,5042,7404,6768,223,6545,782,-331,512,843,1107,20,1087,NA,0,0,0,0,0,NA,NA
"505"," Cullman"," AL","  South"," RED",3362,-13,9120,9133,3433,322,3111,350,-60,990,1050,414,34,380,NA,0,0,0,0,0,NA,NA
"506"," Cullowhee"," NC","  South"," RED",3961,205,5256,5051,3748,631,3117,360,-87,505,592,448,78,370,NA,0,0,0,0,0,NA,NA
"507"," Danville"," KY","  South"," RED",1430,361,5928,5567,1050,112,938,-85,34,639,605,-121,-3,-118,NA,0,0,0,0,0,NA,NA
"508"," Danville"," VA","  South"," BLUE",-6142,-3488,9454,12942,-2608,446,-3054,-1152,-490,934,1424,-659,20,-679,NA,0,0,0,0,0,NA,NA
"509"," Dayton"," TN","  South"," RED",1363,-44,3578,3622,1421,235,1186,256,-17,388,405,272,9,263,NA,0,0,0,0,0,NA,NA
"510"," Decatur"," IN","  Midwest"," RED",1393,3415,6242,2827,-2028,49,-2077,182,415,676,261,-231,8,-239,NA,0,0,0,0,0,NA,NA
"511"," Defiance"," OH","  Midwest"," RED",-939,459,4059,3600,-1403,246,-1649,-2,37,427,390,-37,9,-46,NA,0,0,0,0,0,NA,NA
"512"," Del Rio"," TX","  South"," RED",146,4541,7856,3315,-4443,653,-5096,37,380,759,379,-344,-15,-329,NA,0,0,0,0,0,NA,NA
"513"," Deming"," NM","  West"," BLUE",-1386,780,3544,2764,-2169,88,-2257,-168,65,346,281,-231,16,-247,NA,0,0,0,0,0,NA,NA
"514"," DeRidder"," LA","  South"," RED",1846,1224,4660,3436,634,263,371,128,119,531,412,12,11,1,NA,0,0,0,0,0,NA,NA
"515"," Dickinson"," ND","  Midwest"," RED",7434,2304,4474,2170,4928,506,4422,606,277,516,239,332,35,297,NA,0,0,0,0,0,NA,NA
"516"," Dixon"," IL","  Midwest"," BLUE",-1942,-136,3221,3357,-1809,50,-1859,-200,-38,338,376,-162,7,-169,NA,0,0,0,0,0,NA,NA
"517"," Dodge City"," KS","  Midwest"," RED",-225,3722,5931,2209,-4000,2131,-6131,-258,340,559,219,-602,240,-842,NA,0,0,0,0,0,NA,NA
"518"," Douglas"," GA","  South"," RED",711,2307,6633,4326,-1645,164,-1809,121,242,714,472,-121,-2,-119,NA,0,0,0,0,0,NA,NA
"519"," Dublin"," GA","  South"," RED",-1202,837,7515,6678,-2028,103,-2131,235,43,791,748,192,6,186,NA,0,0,0,0,0,NA,NA
"520"," DuBois"," PA","  Northeast"," RED",-2354,-1757,6918,8675,-533,547,-1080,-317,-211,732,943,-102,59,-161,NA,0,0,0,0,0,NA,NA
"521"," Dumas"," TX","  South"," RED",-964,2506,3815,1309,-3520,957,-4477,-143,239,369,130,-386,29,-415,NA,0,0,0,0,0,NA,NA
"522"," Duncan"," OK","  South"," RED",-1904,-296,4900,5196,-1588,225,-1813,-36,-80,491,571,47,22,25,NA,0,0,0,0,0,NA,NA
"523"," Durango"," CO","  West"," BLUE",4886,1824,4881,3057,3020,-60,3080,-78,105,472,367,-180,-11,-169,NA,0,0,0,0,0,NA,NA
"524"," Durant"," OK","  South"," RED",5579,811,5472,4661,4751,158,4593,804,47,589,542,753,14,739,NA,0,0,0,0,0,NA,NA
"525"," Dyersburg"," TN","  South"," RED",-1171,188,4350,4162,-1349,52,-1401,-127,-13,445,458,-113,-1,-112,NA,0,0,0,0,0,NA,NA
"526"," Eagle Pass"," TX","  South"," RED",4464,6536,9990,3454,-2075,1598,-3673,446,649,1042,393,-204,79,-283,NA,0,0,0,0,0,NA,NA
"527"," Easton"," MD","  South"," BLUE",-600,-940,3099,4039,380,166,214,107,-140,338,478,251,9,242,NA,0,0,0,0,0,NA,NA
"528"," Edwards"," CO","  West"," BLUE",2926,4837,5870,1033,-1929,1022,-2951,184,430,559,129,-246,118,-364,NA,0,0,0,0,0,NA,NA
"529"," Effingham"," IL","  Midwest"," BLUE",-238,888,4216,3328,-1120,110,-1230,-173,94,469,375,-267,6,-273,NA,0,0,0,0,0,NA,NA
"530"," El Campo"," TX","  South"," RED",276,1239,5165,3926,-941,18,-959,57,144,564,420,-85,-15,-70,NA,0,0,0,0,0,NA,NA
"531"," El Dorado"," AR","  South"," RED",-2957,-137,4754,4891,-2845,-20,-2825,-457,-70,480,550,-387,-1,-386,NA,0,0,0,0,0,NA,NA
"532"," Elizabeth City"," NC","  South"," RED",-826,453,5705,5252,-1305,557,-1862,323,63,579,516,260,26,234,NA,0,0,0,0,0,NA,NA
"533"," Elk City"," OK","  South"," RED",-260,953,3150,2197,-1251,9,-1260,139,56,294,238,83,3,80,NA,0,0,0,0,0,NA,NA
"534"," Elkins"," WV","  South"," RED",-710,-523,2855,3378,-168,73,-241,-119,-66,319,385,-51,-2,-49,NA,0,0,0,0,0,NA,NA
"535"," Elko"," NV","  West"," BLUE",3878,4118,6906,2788,-337,-209,-128,270,406,787,381,-136,-45,-91,NA,0,0,0,0,0,NA,NA
"536"," Ellensburg"," WA","  West"," BLUE",7025,1043,3798,2755,5948,735,5213,577,119,426,307,457,81,376,NA,0,0,0,0,0,NA,NA
"537"," Emporia"," KS","  Midwest"," RED",-639,1123,4029,2906,-1792,742,-2534,-57,117,407,290,-174,47,-221,NA,0,0,0,0,0,NA,NA
"538"," Enterprise"," AL","  South"," RED",2387,1103,5844,4741,1272,824,448,392,29,599,570,368,34,334,NA,0,0,0,0,0,NA,NA
"539"," Escanaba"," MI","  Midwest"," RED",-1285,-712,3328,4040,-545,-8,-537,-59,-92,342,434,36,-3,39,NA,0,0,0,0,0,NA,NA
"540"," ola"," NM","  West"," BLUE",-1299,1043,4795,3752,-2343,349,-2692,-102,-42,417,459,-58,30,-88,NA,0,0,0,0,0,NA,NA
"541"," Eufaula"," AL","  South"," RED",-2980,-351,2815,3166,-2642,39,-2681,-147,-64,272,336,-82,13,-95,NA,0,0,0,0,0,NA,NA
"542"," Eureka"," CA","  West"," BLUE",947,1330,13502,12172,-341,167,-508,-686,-38,1352,1390,-642,-17,-625,NA,0,0,0,0,0,NA,NA
"543"," Evanston"," WY","  West"," RED",-895,1463,2755,1292,-2383,-79,-2304,-66,119,255,136,-186,0,-186,NA,0,0,0,0,0,NA,NA
"544"," Fairfield"," IA","  Midwest"," RED",1455,-116,1403,1519,1572,2195,-623,39,-27,158,185,68,142,-74,NA,0,0,0,0,0,NA,NA
"545"," Fairmont"," MN","  Midwest"," BLUE",-1160,-228,2083,2311,-928,11,-939,-89,10,234,224,-97,1,-98,NA,0,0,0,0,0,NA,NA
"546"," Fairmont"," WV","  South"," RED",-361,-260,5925,6185,-48,72,-120,-19,-79,594,673,62,-17,79,NA,0,0,0,0,0,NA,NA
"547"," Fallon"," NV","  West"," BLUE",34,484,2941,2457,-474,302,-776,403,67,327,260,336,-5,341,NA,0,0,0,0,0,NA,NA
"548"," Faribault"," MN","  Midwest"," BLUE",2829,2328,6784,4456,517,1625,-1108,406,253,743,490,156,181,-25,NA,0,0,0,0,0,NA,NA
"549"," Farmington"," MO","  Midwest"," RED",1846,-362,6721,7083,2223,-23,2246,478,-81,693,774,559,-7,566,NA,0,0,0,0,0,NA,NA
"550"," Fergus Falls"," MN","  Midwest"," BLUE",1445,-247,6002,6249,1755,432,1323,76,-36,648,684,118,31,87,NA,0,0,0,0,0,NA,NA
"551"," Fernley"," NV","  West"," BLUE",5528,129,5424,5295,5375,-293,5668,1697,45,664,619,1645,-46,1691,NA,0,0,0,0,0,NA,NA
"552"," Findlay"," OH","  Midwest"," RED",994,1600,8384,6784,-578,1226,-1804,-137,159,881,722,-296,98,-394,NA,0,0,0,0,0,NA,NA
"553"," Fitzgerald"," GA","  South"," RED",-960,90,2099,2009,-1043,18,-1061,-122,-28,197,225,-94,6,-100,NA,0,0,0,0,0,NA,NA
"554"," Forest City"," NC","  South"," RED",-790,-1594,6242,7836,870,32,838,254,-200,662,862,455,-6,461,NA,0,0,0,0,0,NA,NA
"555"," Forrest City"," AR","  South"," RED",-3259,566,3155,2589,-3861,160,-4021,-515,-10,305,315,-506,2,-508,NA,0,0,0,0,0,NA,NA
"556"," Fort Dodge"," IA","  Midwest"," RED",-2107,-59,4055,4114,-2056,411,-2467,-435,3,421,418,-439,28,-467,NA,0,0,0,0,0,NA,NA
"557"," Fort Leonard Wood"," MO","  Midwest"," RED",325,4516,7312,2796,-4301,2625,-6926,610,379,676,297,231,48,183,NA,0,0,0,0,0,NA,NA
"558"," Fort Madison"," IA","  Midwest"," RED",-3933,-399,6208,6607,-3531,70,-3601,-408,-43,620,663,-365,1,-366,NA,0,0,0,0,0,NA,NA
"559"," Fort Morgan"," CO","  West"," BLUE",909,1651,4031,2380,-753,1203,-1956,299,198,438,240,101,171,-70,NA,0,0,0,0,0,NA,NA
"560"," Fort Payne"," AL","  South"," RED",393,559,7756,7197,-117,510,-627,106,-24,795,819,134,44,90,NA,0,0,0,0,0,NA,NA
"561"," Fort Polk South"," LA","  South"," RED",-4932,5703,9292,3589,-10769,1613,-12382,-672,462,828,366,-1130,31,-1161,NA,0,0,0,0,0,NA,NA
"562"," Frankfort"," IN","  Midwest"," RED",-820,745,4072,3327,-1578,145,-1723,207,102,422,320,107,20,87,NA,0,0,0,0,0,NA,NA
"563"," Frankfort"," KY","  South"," RED",3008,885,7769,6884,2180,612,1568,296,107,857,750,190,34,156,NA,0,0,0,0,0,NA,NA
"564"," Fredericksburg"," TX","  South"," RED",2160,-919,2315,3234,3079,272,2807,286,-125,248,373,409,12,397,NA,0,0,0,0,0,NA,NA
"565"," Freeport"," IL","  Midwest"," BLUE",-3210,-455,4551,5006,-2768,199,-2967,-299,-71,476,547,-228,24,-252,NA,0,0,0,0,0,NA,NA
"566"," Fremont"," NE","  Midwest"," RED",-120,413,4442,4029,-520,468,-988,-160,54,454,400,-214,61,-275,NA,0,0,0,0,0,NA,NA
"567"," Fremont"," OH","  Midwest"," RED",-2428,148,6111,5963,-2570,86,-2656,-222,-21,603,624,-199,2,-201,NA,0,0,0,0,0,NA,NA
"568"," Gaffney"," SC","  South"," RED",1812,517,6226,5709,1340,-93,1433,231,28,652,624,205,-9,214,NA,0,0,0,0,0,NA,NA
"569"," Gainesville"," TX","  South"," RED",2821,1240,4979,3739,1584,361,1223,753,113,530,417,639,23,616,NA,0,0,0,0,0,NA,NA
"570"," Galesburg"," IL","  Midwest"," BLUE",-3227,-1115,5149,6264,-2083,754,-2837,-279,-61,559,620,-219,77,-296,NA,0,0,0,0,0,NA,NA
"571"," Gallup"," NM","  West"," BLUE",-118,4418,9926,5508,-4557,489,-5046,-544,175,817,642,-721,17,-738,NA,0,0,0,0,0,NA,NA
"572"," Garden City"," KS","  Midwest"," RED",-462,4562,6849,2287,-5082,1277,-6359,-164,441,672,231,-610,110,-720,NA,0,0,0,0,0,NA,NA
"573"," Gardnerville Ranchos"," NV","  West"," BLUE",1905,-1368,3041,4409,3304,-23,3327,416,-262,287,549,675,-16,691,NA,0,0,0,0,0,NA,NA
"574"," Georgetown"," SC","  South"," RED",2369,-1682,5241,6923,4073,52,4021,448,-358,521,879,804,-13,817,NA,0,0,0,0,0,NA,NA
"575"," Gillette"," WY","  West"," RED",431,4721,8273,3552,-4360,310,-4670,184,293,761,468,-110,71,-181,NA,0,0,0,0,0,NA,NA
"576"," Glasgow"," KY","  South"," RED",2043,577,6288,5711,1494,200,1294,135,23,670,647,114,-1,115,NA,0,0,0,0,0,NA,NA
"577"," Glenwood Springs"," CO","  West"," BLUE",4311,5328,8759,3431,-1040,1053,-2093,151,476,911,435,-327,147,-474,NA,0,0,0,0,0,NA,NA
"578"," Gloversville"," NY","  Northeast"," BLUE",-2130,-631,4935,5566,-1485,118,-1603,-250,-48,517,565,-203,0,-203,NA,0,0,0,0,0,NA,NA
"579"," Granbury"," TX","  South"," RED",10480,-650,5519,6169,11054,342,10712,1466,-109,627,736,1567,2,1565,NA,0,0,0,0,0,NA,NA
"580"," Grand Rapids"," MN","  Midwest"," BLUE",72,-505,4284,4789,625,62,563,79,-61,441,502,144,8,136,NA,0,0,0,0,0,NA,NA
"581"," Grants"," NM","  West"," BLUE",-540,967,3348,2381,-1518,190,-1708,-91,43,306,263,-134,9,-143,NA,0,0,0,0,0,NA,NA
"582"," Great Bend"," KS","  Midwest"," RED",-1893,372,3123,2751,-2263,31,-2294,-278,-33,271,304,-245,5,-250,NA,0,0,0,0,0,NA,NA
"583"," Greeneville"," TN","  South"," RED",244,-2254,5954,8208,2548,113,2435,-95,-243,665,908,153,9,144,NA,0,0,0,0,0,NA,NA
"584"," Greensburg"," IN","  Midwest"," RED",820,651,3096,2445,190,187,3,-166,47,320,273,-215,17,-232,NA,0,0,0,0,0,NA,NA
"585"," Greenville"," MS","  South"," RED",-7226,1219,6660,5441,-8517,112,-8629,-1127,-43,565,608,-1088,19,-1107,NA,0,0,0,0,0,NA,NA
"586"," Greenville"," OH","  Midwest"," RED",-1855,293,5748,5455,-2138,89,-2227,-186,14,618,604,-199,10,-209,NA,0,0,0,0,0,NA,NA
"587"," Greenwood"," MS","  South"," RED",-4849,828,5199,4371,-5752,57,-5809,-406,32,496,464,-439,-7,-432,NA,0,0,0,0,0,NA,NA
"588"," Greenwood"," SC","  South"," RED",1120,1101,7926,6825,58,773,-715,214,8,811,803,208,76,132,NA,0,0,0,0,0,NA,NA
"589"," Grenada"," MS","  South"," RED",-1140,-253,2482,2735,-876,-26,-850,-226,-41,247,288,-185,-3,-182,NA,0,0,0,0,0,NA,NA
"590"," Guymon"," OK","  South"," RED",-657,1889,3423,1534,-2596,817,-3413,-508,201,350,149,-714,61,-775,NA,0,0,0,0,0,NA,NA
"591"," Hailey"," ID","  West"," RED",1633,1065,2086,1021,566,868,-302,235,90,202,112,146,119,27,NA,0,0,0,0,0,NA,NA
"592"," Hannibal"," MO","  Midwest"," RED",-117,414,4295,3881,-503,109,-612,65,61,447,386,5,12,-7,NA,0,0,0,0,0,NA,NA
"593"," Harrison"," AR","  South"," RED",-50,-145,4841,4986,123,-77,200,0,-77,491,568,81,-11,92,NA,0,0,0,0,0,NA,NA
"594"," Hastings"," NE","  Midwest"," RED",-4,871,3745,2874,-863,366,-1229,-151,75,391,316,-227,59,-286,NA,0,0,0,0,0,NA,NA
"595"," Hays"," KS","  Midwest"," RED",101,934,3252,2318,-840,530,-1370,-93,46,294,248,-140,44,-184,NA,0,0,0,0,0,NA,NA
"596"," Heber"," UT","  West"," RED",16387,5403,7932,2529,10899,1322,9577,1279,564,868,304,711,155,556,NA,0,0,0,0,0,NA,NA
"597"," Helena"," MT","  West"," RED",6856,1433,7882,6449,5438,157,5281,937,56,847,791,883,-15,898,NA,0,0,0,0,0,NA,NA
"598"," Helena"," AR","  South"," RED",-3973,305,2759,2454,-4337,-25,-4312,-272,12,267,255,-285,-4,-281,NA,0,0,0,0,0,NA,NA
"599"," Henderson"," NC","  South"," RED",-873,577,5235,4658,-1451,173,-1624,-100,46,571,525,-145,32,-177,NA,0,0,0,0,0,NA,NA
"600"," Hereford"," TX","  South"," RED",-826,1765,3115,1350,-2622,184,-2806,-165,161,320,159,-327,-2,-325,NA,0,0,0,0,0,NA,NA
"601"," Hermiston"," OR","  West"," BLUE",2491,4351,11050,6699,-1843,278,-2121,772,363,1115,752,413,50,363,NA,0,0,0,0,0,NA,NA
"602"," Hillsdale"," MI","  Midwest"," RED",-1086,591,4981,4390,-1664,29,-1693,-97,29,509,480,-127,2,-129,NA,0,0,0,0,0,NA,NA
"603"," Hilo"," HI","  West"," BLUE",16437,6466,21947,15481,10050,4742,5308,4,234,2237,2003,-216,427,-643,NA,0,0,0,0,0,NA,NA
"604"," Hobbs"," NM","  West"," BLUE",6344,5350,10279,4929,919,1104,-185,1527,579,1086,507,945,22,923,NA,0,0,0,0,0,NA,NA
"605"," Holland"," MI","  Midwest"," RED",6681,3682,12481,8799,3069,574,2495,908,360,1285,925,553,49,504,NA,0,0,0,0,0,NA,NA
"606"," Hood River"," OR","  West"," BLUE",1036,906,2546,1640,139,25,114,115,79,250,171,36,1,35,NA,0,0,0,0,0,NA,NA
"607"," Hope"," AR","  South"," RED",-1823,643,3944,3301,-2474,-123,-2351,-209,56,393,337,-266,-16,-250,NA,0,0,0,0,0,NA,NA
"608"," Houghton"," MI","  Midwest"," RED",-981,137,3610,3473,-1141,1261,-2402,-233,-3,368,371,-232,64,-296,NA,0,0,0,0,0,NA,NA
"609"," Hudson"," NY","  Northeast"," BLUE",-3605,-1386,4849,6235,-2178,516,-2694,-324,-187,489,676,-135,43,-178,NA,0,0,0,0,0,NA,NA
"610"," Huntingdon"," PA","  Northeast"," RED",-856,-686,3647,4333,-132,283,-415,-251,-178,354,532,-72,35,-107,NA,0,0,0,0,0,NA,NA
"611"," Huntington"," IN","  Midwest"," RED",-603,111,3895,3784,-705,108,-813,277,21,411,390,258,20,238,NA,0,0,0,0,0,NA,NA
"612"," Huntsville"," TX","  South"," RED",5111,977,5746,4769,4100,1513,2587,-165,-1,592,593,-168,151,-319,NA,0,0,0,0,0,NA,NA
"613"," Huron"," SD","  Midwest"," RED",996,1072,3092,2020,-85,1621,-1706,17,103,305,202,-85,54,-139,NA,0,0,0,0,0,NA,NA
"614"," Hutchinson"," KS","  Midwest"," RED",-2513,-250,6619,6869,-2229,229,-2458,-333,-29,670,699,-302,38,-340,NA,0,0,0,0,0,NA,NA
"615"," Hutchinson"," MN","  Midwest"," BLUE",-752,713,3792,3079,-1475,138,-1613,66,47,372,325,22,5,17,NA,0,0,0,0,0,NA,NA
"616"," Indiana"," PA","  Northeast"," RED",-4812,-894,7555,8449,-3912,643,-4555,-368,-136,760,896,-231,50,-281,NA,0,0,0,0,0,NA,NA
"617"," Indianola"," MS","  South"," RED",-4273,151,2955,2804,-4515,43,-4558,-1101,-32,275,307,-1078,3,-1081,NA,0,0,0,0,0,NA,NA
"618"," Iron Mountain"," MI","  Midwest"," RED",-1057,-776,2562,3338,-268,-7,-261,-131,-87,265,352,-42,-2,-40,NA,0,0,0,0,0,NA,NA
"619"," Jackson"," OH","  Midwest"," RED",-806,99,3890,3791,-898,133,-1031,47,7,408,401,42,12,30,NA,0,0,0,0,0,NA,NA
"620"," Jackson"," WY","  West"," RED",4143,2557,3663,1106,1536,706,830,686,245,363,118,437,94,343,NA,0,0,0,0,0,NA,NA
"621"," Jacksonville"," IL","  Midwest"," BLUE",-2291,-375,3824,4199,-1907,378,-2285,-345,-40,398,438,-306,50,-356,NA,0,0,0,0,0,NA,NA
"622"," Jacksonville"," TX","  South"," RED",1812,1996,6916,4920,-141,156,-297,265,169,722,553,97,3,94,NA,0,0,0,0,0,NA,NA
"623"," Jamestown"," ND","  Midwest"," RED",-396,-59,2134,2193,-326,128,-454,-171,9,223,214,-181,8,-189,NA,0,0,0,0,0,NA,NA
"624"," Jamestown"," NY","  Northeast"," BLUE",-8004,-674,12718,13392,-7370,1524,-8894,-569,-116,1282,1398,-450,21,-471,NA,0,0,0,0,0,NA,NA
"625"," Jasper"," AL","  South"," RED",-3499,-1956,7318,9274,-1495,108,-1603,-148,-219,750,969,74,-1,75,NA,0,0,0,0,0,NA,NA
"626"," Jasper"," IN","  Midwest"," RED",539,1279,6337,5058,-720,644,-1364,63,136,690,554,-72,112,-184,NA,0,0,0,0,0,NA,NA
"627"," Jefferson"," GA","  South"," RED",12516,2353,7545,5192,10117,213,9904,2652,304,918,614,2337,26,2311,NA,0,0,0,0,0,NA,NA
"628"," Jennings"," LA","  South"," RED",-224,431,3908,3477,-640,41,-681,-169,-26,384,410,-143,6,-149,NA,0,0,0,0,0,NA,NA
"629"," Jesup"," GA","  South"," RED",-170,533,3631,3098,-722,109,-831,117,2,360,358,116,8,108,NA,0,0,0,0,0,NA,NA
"630"," Juneau"," AK","  West"," RED",698,1767,3479,1712,-1073,617,-1690,-63,163,340,177,-227,20,-247,NA,0,0,0,0,0,NA,NA
"631"," Kalispell"," MT","  West"," RED",12879,2377,10303,7926,10453,30,10423,1789,196,1113,917,1587,-42,1629,NA,0,0,0,0,0,NA,NA
"632"," Kapaa"," HI","  West"," BLUE",5198,2469,7902,5433,2788,2802,-14,125,90,794,704,39,269,-230,NA,0,0,0,0,0,NA,NA
"633"," Kearney"," NE","  Midwest"," RED",3566,3205,7095,3890,380,728,-348,263,281,712,431,-15,37,-52,NA,0,0,0,0,0,NA,NA
"634"," Keene"," NH","  Northeast"," BLUE",-1037,-368,6223,6591,-631,565,-1196,184,-82,636,718,269,52,217,NA,0,0,0,0,0,NA,NA
"635"," Kendallville"," IN","  Midwest"," RED",206,1497,5629,4132,-1275,-3,-1272,201,177,632,455,27,15,12,NA,0,0,0,0,0,NA,NA
"636"," Kennett"," MO","  Midwest"," RED",-2826,-109,3946,4055,-2732,195,-2927,-347,-90,357,447,-258,29,-287,NA,0,0,0,0,0,NA,NA
"637"," Kerrville"," TX","  South"," RED",2956,-1875,4812,6687,4829,325,4504,185,-217,530,747,403,29,374,NA,0,0,0,0,0,NA,NA
"638"," Ketchikan"," AK","  West"," RED",375,677,1540,863,-305,358,-663,45,65,153,88,-18,24,-42,NA,0,0,0,0,0,NA,NA
"639"," Key West"," FL","  South"," RED",1138,190,6687,6497,931,3279,-2348,-529,-51,685,736,-477,273,-750,NA,0,0,0,0,0,NA,NA
"640"," Kill Devil Hills"," NC","  South"," RED",3089,208,3233,3025,2876,244,2632,402,-28,332,360,430,40,390,NA,0,0,0,0,0,NA,NA
"641"," Kingsville"," TX","  South"," RED",-1390,1768,4171,2403,-3210,876,-4086,-75,163,408,245,-239,50,-289,NA,0,0,0,0,0,NA,NA
"642"," Kinston"," NC","  South"," RED",-3558,-625,5994,6619,-2923,261,-3184,-41,-160,608,768,122,42,80,NA,0,0,0,0,0,NA,NA
"643"," Kirksville"," MO","  Midwest"," RED",-34,577,3044,2467,-613,828,-1441,-67,101,343,242,-169,101,-270,NA,0,0,0,0,0,NA,NA
"644"," Klamath Falls"," OR","  West"," BLUE",1854,234,7360,7126,1647,85,1562,551,-67,767,834,618,-2,620,NA,0,0,0,0,0,NA,NA
"645"," Laconia"," NH","  Northeast"," BLUE",1228,-1440,4828,6268,2721,493,2228,158,-297,478,775,460,28,432,NA,0,0,0,0,0,NA,NA
"646"," La Grande"," OR","  West"," BLUE",1091,278,2743,2465,822,178,644,134,-3,277,280,137,11,126,NA,0,0,0,0,0,NA,NA
"647"," LaGrange"," GA","  South"," RED",1967,1463,11966,10503,560,944,-384,-502,36,1240,1204,-542,100,-642,NA,0,0,0,0,0,NA,NA
"648"," Lake City"," FL","  South"," RED",4160,117,7437,7320,4042,297,3745,1018,-59,804,863,1069,4,1065,NA,0,0,0,0,0,NA,NA
"649"," Lamesa"," TX","  South"," RED",-1105,447,1710,1263,-1597,162,-1759,123,54,181,127,70,10,60,NA,0,0,0,0,0,NA,NA
"650"," Laramie"," WY","  West"," RED",2581,1911,3659,1748,660,1526,-866,152,143,341,198,6,259,-253,NA,0,0,0,0,0,NA,NA
"651"," Las Vegas"," NM","  West"," BLUE",-2458,113,3098,2985,-2603,551,-3154,-169,-31,277,308,-139,41,-180,NA,0,0,0,0,0,NA,NA
"652"," Laurel"," MS","  South"," RED",-360,2015,10788,8773,-2345,130,-2475,-140,66,1065,999,-203,18,-221,NA,0,0,0,0,0,NA,NA
"653"," Laurinburg"," NC","  South"," RED",-1337,481,4177,3696,-1827,144,-1971,72,9,436,427,66,13,53,NA,0,0,0,0,0,NA,NA
"654"," Lawrenceburg"," TN","  South"," RED",2286,374,5275,4901,1928,24,1904,371,46,585,539,326,-5,331,NA,0,0,0,0,0,NA,NA
"655"," Lebanon"," MO","  Midwest"," RED",127,708,4388,3680,-576,-34,-542,127,78,474,396,51,-2,53,NA,0,0,0,0,0,NA,NA
"656"," Lebanon"," NH","  Northeast"," BLUE",-1486,-1915,17387,19302,591,2821,-2230,79,-326,1755,2081,419,161,258,NA,0,0,0,0,0,NA,NA
"657"," Levelland"," TX","  South"," RED",94,993,2927,1934,-897,80,-977,50,105,306,201,-55,-1,-54,NA,0,0,0,0,0,NA,NA
"658"," Lewisburg"," PA","  Northeast"," RED",-40,187,3719,3532,-239,337,-576,-94,-20,402,422,-74,2,-76,NA,0,0,0,0,0,NA,NA
"659"," Lewisburg"," TN","  South"," RED",3764,505,3508,3003,3274,247,3027,569,67,411,344,500,15,485,NA,0,0,0,0,0,NA,NA
"660"," Lewistown"," PA","  Northeast"," RED",-541,363,5315,4952,-862,148,-1010,-73,47,574,527,-117,11,-128,NA,0,0,0,0,0,NA,NA
"661"," Lexington"," NE","  Midwest"," RED",-785,1721,3849,2128,-2537,938,-3475,-155,210,424,214,-366,116,-482,NA,0,0,0,0,0,NA,NA
"662"," Liberal"," KS","  Midwest"," RED",-1522,2838,4026,1188,-4402,958,-5360,-474,293,403,110,-772,106,-878,NA,0,0,0,0,0,NA,NA
"663"," Lincoln"," IL","  Midwest"," BLUE",-1687,-322,2779,3101,-1378,126,-1504,-294,-48,286,334,-245,13,-258,NA,0,0,0,0,0,NA,NA
"664"," Lock Haven"," PA","  Northeast"," RED",-621,169,3845,3676,-778,116,-894,-64,-28,368,396,-33,8,-41,NA,0,0,0,0,0,NA,NA
"665"," Logansport"," IN","  Midwest"," RED",-1281,788,4470,3682,-2089,817,-2906,-206,37,452,415,-242,112,-354,NA,0,0,0,0,0,NA,NA
"666"," London"," KY","  South"," RED",24,1999,18156,16157,-1919,253,-2172,-26,66,1876,1810,-86,-21,-65,NA,0,0,0,0,0,NA,NA
"667"," Los Alamos"," NM","  West"," BLUE",1419,424,1565,1141,964,690,274,381,62,173,111,318,62,256,NA,0,0,0,0,0,NA,NA
"668"," Ludington"," MI","  Midwest"," RED",455,-350,2709,3059,831,78,753,60,-21,285,306,83,4,79,NA,0,0,0,0,0,NA,NA
"669"," Lufkin"," TX","  South"," RED",-56,2576,10851,8275,-2578,241,-2819,-95,74,1071,997,-167,6,-173,NA,0,0,0,0,0,NA,NA
"670"," Lumberton"," NC","  South"," RED",-3604,4701,16897,12196,-8274,511,-8785,-1259,319,1697,1378,-1578,58,-1636,NA,0,0,0,0,0,NA,NA
"671"," Macomb"," IL","  Midwest"," BLUE",-2934,-200,2631,2831,-2771,685,-3456,-302,-38,258,296,-267,77,-344,NA,0,0,0,0,0,NA,NA
"672"," Madison"," IN","  Midwest"," RED",-92,-55,3396,3451,-12,103,-115,151,22,372,350,133,10,123,NA,0,0,0,0,0,NA,NA
"673"," Madisonville"," KY","  South"," RED",-2232,-527,4970,5497,-1687,189,-1876,-338,-20,525,545,-318,7,-325,NA,0,0,0,0,0,NA,NA
"674"," Magnolia"," AR","  South"," RED",-1095,-173,2647,2820,-949,259,-1208,-129,-17,262,279,-111,9,-120,NA,0,0,0,0,0,NA,NA
"675"," Malone"," NY","  Northeast"," BLUE",-1579,241,4513,4272,-1846,182,-2028,-257,-80,444,524,-177,-6,-171,NA,0,0,0,0,0,NA,NA
"676"," Malvern"," AR","  South"," RED",760,-333,3298,3631,1076,29,1047,99,-18,361,379,118,-1,119,NA,0,0,0,0,0,NA,NA
"677"," Manitowoc"," WI","  Midwest"," RED",-2463,-433,7431,7864,-2018,550,-2568,-34,-59,757,816,31,67,-36,NA,0,0,0,0,0,NA,NA
"678"," Marietta"," OH","  Midwest"," RED",-1876,-1152,5615,6767,-671,165,-836,-200,-131,594,725,-66,10,-76,NA,0,0,0,0,0,NA,NA
"679"," Marinette"," WI","  Midwest"," RED",-2648,-1848,5293,7141,-747,54,-801,-199,-179,541,720,-14,1,-15,NA,0,0,0,0,0,NA,NA
"680"," Marion"," IN","  Midwest"," RED",-4294,-561,7002,7563,-3737,187,-3924,-270,-60,750,810,-209,26,-235,NA,0,0,0,0,0,NA,NA
"681"," Marion"," NC","  South"," RED",754,-497,4199,4696,1296,229,1067,291,-76,437,513,368,39,329,NA,0,0,0,0,0,NA,NA
"682"," Marion"," OH","  Midwest"," RED",-1412,319,7009,6690,-1714,270,-1984,-334,3,734,731,-336,28,-364,NA,0,0,0,0,0,NA,NA
"683"," Marquette"," MI","  Midwest"," RED",-372,-361,5794,6155,24,376,-352,318,-109,570,679,427,30,397,NA,0,0,0,0,0,NA,NA
"684"," Marshall"," MN","  Midwest"," BLUE",-384,1313,3354,2041,-1727,853,-2580,-109,115,343,228,-225,94,-319,NA,0,0,0,0,0,NA,NA
"685"," Marshall"," MO","  Midwest"," RED",-609,228,2556,2328,-833,387,-1220,-129,-1,240,241,-129,45,-174,NA,0,0,0,0,0,NA,NA
"686"," Marshalltown"," IA","  Midwest"," RED",-1279,547,4962,4415,-1836,986,-2822,-519,36,514,478,-556,35,-591,NA,0,0,0,0,0,NA,NA
"687"," Martin"," TN","  South"," RED",-1687,-286,3177,3463,-1409,251,-1660,-85,-48,311,359,-34,34,-68,NA,0,0,0,0,0,NA,NA
"688"," Martinsville"," VA","  South"," BLUE",-4885,-2765,6085,8850,-2083,187,-2270,-566,-400,583,983,-164,6,-170,NA,0,0,0,0,0,NA,NA
"689"," Maryville"," MO","  Midwest"," RED",-1281,270,2051,1781,-1567,110,-1677,-131,9,195,186,-141,4,-145,NA,0,0,0,0,0,NA,NA
"690"," Mason City"," IA","  Midwest"," RED",-1913,-419,5015,5434,-1478,240,-1718,-224,-45,519,564,-178,15,-193,NA,0,0,0,0,0,NA,NA
"691"," Mayfield"," KY","  South"," RED",115,525,4645,4120,-394,442,-836,-53,72,492,420,-125,19,-144,NA,0,0,0,0,0,NA,NA
"692"," Maysville"," KY","  South"," RED",-420,-4,1942,1946,-414,83,-497,-10,18,208,190,-26,11,-37,NA,0,0,0,0,0,NA,NA
"693"," McAlester"," OK","  South"," RED",-2173,-837,4838,5675,-1308,42,-1350,-216,-108,508,616,-108,3,-111,NA,0,0,0,0,0,NA,NA
"694"," McComb"," MS","  South"," RED",-1113,431,5119,4688,-1533,22,-1555,-92,9,540,531,-100,4,-104,NA,0,0,0,0,0,NA,NA
"695"," McMinnville"," TN","  South"," RED",1453,-63,4408,4471,1547,339,1208,451,2,473,471,450,37,413,NA,0,0,0,0,0,NA,NA
"696"," McPherson"," KS","  Midwest"," RED",-644,-404,3016,3420,-236,66,-302,14,-31,305,336,47,0,47,NA,0,0,0,0,0,NA,NA
"697"," Meadville"," PA","  Northeast"," RED",-4121,-615,8627,9242,-3470,193,-3663,-481,-53,908,961,-425,22,-447,NA,0,0,0,0,0,NA,NA
"698"," Menomonie"," WI","  Midwest"," RED",1503,1165,4153,2988,357,315,42,277,110,430,320,171,16,155,NA,0,0,0,0,0,NA,NA
"699"," Meridian"," MS","  South"," RED",-8038,1025,11877,10852,-9108,235,-9343,-1148,23,1199,1176,-1173,-26,-1147,NA,0,0,0,0,0,NA,NA
"700"," Mexico"," MO","  Midwest"," RED",-143,382,3126,2744,-514,24,-538,-35,37,309,272,-72,4,-76,NA,0,0,0,0,0,NA,NA
"701"," Miami"," OK","  South"," RED",-721,-86,4051,4137,-630,134,-764,-192,-61,409,470,-131,15,-146,NA,0,0,0,0,0,NA,NA
"702"," Middlesborough"," KY","  South"," RED",-2659,-402,3168,3570,-2268,23,-2291,-455,-63,316,379,-393,5,-398,NA,0,0,0,0,0,NA,NA
"703"," Milledgeville"," GA","  South"," RED",-1894,-76,4813,4889,-1923,323,-2246,86,-140,460,600,228,31,197,NA,0,0,0,0,0,NA,NA
"704"," Minden"," LA","  South"," RED",-2867,-260,4608,4868,-2607,46,-2653,-452,-79,452,531,-371,5,-376,NA,0,0,0,0,0,NA,NA
"705"," Mineral Wells"," TX","  South"," RED",1057,314,3311,2997,752,86,666,315,9,352,343,306,2,304,NA,0,0,0,0,0,NA,NA
"706"," Minot"," ND","  Midwest"," RED",6176,6349,11622,5273,-344,2223,-2567,-166,603,1180,577,-770,117,-887,NA,0,0,0,0,0,NA,NA
"707"," Mitchell"," SD","  Midwest"," RED",392,594,2758,2164,-192,204,-396,80,73,281,208,7,-4,11,NA,0,0,0,0,0,NA,NA
"708"," Moberly"," MO","  Midwest"," RED",-670,117,2640,2523,-789,42,-831,16,53,292,239,-37,5,-42,NA,0,0,0,0,0,NA,NA
"709"," Montrose"," CO","  West"," BLUE",1992,216,4412,4196,1771,43,1728,682,-20,448,468,700,16,684,NA,0,0,0,0,0,NA,NA
"710"," Morehead City"," NC","  South"," RED",3010,-1967,5430,7397,4989,576,4413,35,-363,531,894,400,22,378,NA,0,0,0,0,0,NA,NA
"711"," Morgan City"," LA","  South"," RED",-5299,1655,6797,5142,-7020,590,-7610,-493,90,647,557,-584,38,-622,NA,0,0,0,0,0,NA,NA
"712"," Moscow"," ID","  West"," RED",2865,2029,4094,2065,850,1233,-383,279,207,422,215,72,52,20,NA,0,0,0,0,0,NA,NA
"713"," Moses Lake"," WA","  West"," BLUE",8609,7715,14050,6335,942,1242,-300,1061,767,1486,719,296,81,215,NA,0,0,0,0,0,NA,NA
"714"," Moultrie"," GA","  South"," RED",104,1765,6136,4371,-1647,138,-1785,145,134,605,471,11,-18,29,NA,0,0,0,0,0,NA,NA
"715"," Mountain Home"," AR","  South"," RED",421,-2988,3244,6232,3427,20,3407,308,-346,349,695,655,-1,656,NA,0,0,0,0,0,NA,NA
"716"," Mountain Home"," ID","  West"," RED",471,2617,4302,1685,-2201,1131,-3332,149,261,456,195,-113,40,-153,NA,0,0,0,0,0,NA,NA
"717"," Mount Airy"," NC","  South"," RED",-1966,-1114,6974,8088,-802,301,-1103,-176,-138,736,874,-32,40,-72,NA,0,0,0,0,0,NA,NA
"718"," Mount Gay"," WV","  South"," RED",-4735,-1318,3631,4949,-3441,-13,-3428,-590,-138,349,487,-453,-1,-452,NA,0,0,0,0,0,NA,NA
"719"," Mount Pleasant"," MI","  Midwest"," RED",-441,1762,6129,4367,-2256,1819,-4075,-591,200,660,460,-800,121,-921,NA,0,0,0,0,0,NA,NA
"720"," Mount Pleasant"," TX","  South"," RED",1109,2468,6319,3851,-1362,628,-1990,118,256,651,395,-139,-3,-136,NA,0,0,0,0,0,NA,NA
"721"," Mount Sterling"," KY","  South"," RED",2743,1061,5716,4655,1697,-56,1753,156,62,605,543,97,-12,109,NA,0,0,0,0,0,NA,NA
"722"," Mount Vernon"," IL","  Midwest"," BLUE",-1141,263,4413,4150,-1384,267,-1651,-24,7,452,445,-30,14,-44,NA,0,0,0,0,0,NA,NA
"723"," Mount Vernon"," OH","  Midwest"," RED",1394,1064,6777,5713,356,-3,359,422,111,741,630,314,-5,319,NA,0,0,0,0,0,NA,NA
"724"," Murray"," KY","  South"," RED",1811,-85,3545,3630,1896,1131,765,37,-48,359,407,85,14,71,NA,0,0,0,0,0,NA,NA
"725"," Muscatine"," IA","  Midwest"," RED",-139,1349,5002,3653,-1485,728,-2213,-210,154,526,372,-365,47,-412,NA,0,0,0,0,0,NA,NA
"726"," Muskogee"," OK","  South"," RED",-3000,-176,8395,8571,-2810,155,-2965,-327,-85,821,906,-243,7,-250,NA,0,0,0,0,0,NA,NA
"727"," Nacogdoches"," TX","  South"," RED",680,2675,7926,5251,-2014,516,-2530,43,166,770,604,-123,2,-125,NA,0,0,0,0,0,NA,NA
"728"," Natchez"," MS","  South"," RED",-3170,-175,5873,6048,-3043,1455,-4498,-678,-74,594,668,-606,143,-749,NA,0,0,0,0,0,NA,NA
"729"," Natchitoches"," LA","  South"," RED",-1411,1096,4785,3689,-2496,169,-2665,-458,70,468,398,-528,23,-551,NA,0,0,0,0,0,NA,NA
"730"," Newberry"," SC","  South"," RED",930,25,4014,3989,933,121,812,-3,-59,395,454,57,-1,58,NA,0,0,0,0,0,NA,NA
"731"," New Castle"," IN","  Midwest"," RED",-1494,-1032,4326,5358,-428,29,-457,-159,-101,448,549,-56,4,-60,NA,0,0,0,0,0,NA,NA
"732"," New Castle"," PA","  Northeast"," RED",-5645,-2383,8207,10590,-3229,196,-3425,-616,-227,863,1090,-387,9,-396,NA,0,0,0,0,0,NA,NA
"733"," New Philadelphia"," OH","  Midwest"," RED",-598,937,10494,9557,-1472,638,-2110,-92,50,1098,1048,-137,26,-163,NA,0,0,0,0,0,NA,NA
"734"," Newport"," OR","  West"," BLUE",3929,-1541,3903,5444,5428,150,5278,738,-224,385,609,959,0,959,NA,0,0,0,0,0,NA,NA
"735"," Newport"," TN","  South"," RED",362,-1106,3510,4616,1496,-47,1543,146,-135,361,496,282,-10,292,NA,0,0,0,0,0,NA,NA
"736"," New Ulm"," MN","  Midwest"," BLUE",-885,-173,2535,2708,-705,93,-798,-117,1,276,275,-117,8,-125,NA,0,0,0,0,0,NA,NA
"737"," Nogales"," AZ","  West"," RED",-922,3314,5987,2673,-4313,795,-5108,103,303,619,316,-201,56,-257,NA,0,0,0,0,0,NA,NA
"738"," Norfolk"," NE","  Midwest"," RED",-103,1875,6242,4367,-1980,741,-2721,-137,178,652,474,-319,74,-393,NA,0,0,0,0,0,NA,NA
"739"," North Platte"," NE","  Midwest"," RED",-1434,640,4058,3418,-2082,180,-2262,-237,67,423,356,-305,19,-324,NA,0,0,0,0,0,NA,NA
"740"," North Vernon"," IN","  Midwest"," RED",-794,438,3131,2693,-1229,-17,-1212,56,36,338,302,22,-1,23,NA,0,0,0,0,0,NA,NA
"741"," North Wilkesboro"," NC","  South"," RED",-898,-1032,6284,7316,206,333,-127,-151,-147,670,817,2,52,-50,NA,0,0,0,0,0,NA,NA
"742"," Norwalk"," OH","  Midwest"," RED",-1357,1351,6761,5410,-2722,167,-2889,-98,109,698,589,-206,-4,-202,NA,0,0,0,0,0,NA,NA
"743"," Oak Harbor"," WA","  West"," BLUE",6633,1947,8445,6498,4661,1580,3081,914,154,916,762,759,59,700,NA,0,0,0,0,0,NA,NA
"744"," Ogdensburg"," NY","  Northeast"," BLUE",-4200,1356,10627,9271,-5584,1241,-6825,-587,-94,988,1082,-495,96,-591,NA,0,0,0,0,0,NA,NA
"745"," Oil City"," PA","  Northeast"," RED",-4320,-1209,4867,6076,-3102,15,-3117,-533,-228,452,680,-305,1,-306,NA,0,0,0,0,0,NA,NA
"746"," Okeechobee"," FL","  South"," RED",2172,927,4912,3985,1256,666,590,514,95,542,447,419,61,358,NA,0,0,0,0,0,NA,NA
"747"," Olean"," NY","  Northeast"," BLUE",-4220,482,8188,7706,-4720,230,-4950,-609,-47,801,848,-560,5,-565,NA,0,0,0,0,0,NA,NA
"748"," Oneonta"," NY","  Northeast"," BLUE",-2785,-871,4770,5641,-1893,338,-2231,-317,-163,485,648,-149,25,-174,NA,0,0,0,0,0,NA,NA
"749"," Ontario"," OR","  West"," BLUE",584,2074,6750,4676,-1491,-361,-1130,462,228,702,474,235,-48,283,NA,0,0,0,0,0,NA,NA
"750"," Opelousas"," LA","  South"," RED",-1266,2754,11659,8905,-3972,12,-3984,-658,94,1111,1017,-750,6,-756,NA,0,0,0,0,0,NA,NA
"751"," Orangeburg"," SC","  South"," RED",-6333,-169,9641,9810,-6179,317,-6496,-838,-204,950,1154,-631,24,-655,NA,0,0,0,0,0,NA,NA
"752"," Oskaloosa"," IA","  Midwest"," RED",-287,462,2573,2111,-740,211,-951,77,49,266,217,30,15,15,NA,0,0,0,0,0,NA,NA
"753"," Othello"," WA","  West"," BLUE",1252,2581,3664,1083,-1346,225,-1571,247,288,388,100,-41,24,-65,NA,0,0,0,0,0,NA,NA
"754"," Ottawa"," IL","  Midwest"," BLUE",-7870,-1525,14631,16156,-6322,555,-6877,-818,-205,1485,1690,-611,47,-658,NA,0,0,0,0,0,NA,NA
"755"," Ottawa"," KS","  Midwest"," RED",-452,491,2894,2403,-936,89,-1025,-81,45,295,250,-127,9,-136,NA,0,0,0,0,0,NA,NA
"756"," Ottumwa"," IA","  Midwest"," RED",-655,294,4056,3762,-928,953,-1881,-22,44,436,392,-67,87,-154,NA,0,0,0,0,0,NA,NA
"757"," Owatonna"," MN","  Midwest"," BLUE",68,1354,4164,2810,-1292,41,-1333,-89,83,391,308,-172,-6,-166,NA,0,0,0,0,0,NA,NA
"758"," Oxford"," MS","  South"," RED",6658,1544,5037,3493,4974,356,4618,477,118,513,395,361,19,342,NA,0,0,0,0,0,NA,NA
"759"," Ozark"," AL","  South"," RED",-1079,1525,6137,4612,-2604,702,-3306,29,102,648,546,-71,18,-89,NA,0,0,0,0,0,NA,NA
"760"," Paducah"," KY","  South"," RED",-2463,-1203,10317,11520,-1191,37,-1228,-294,-179,1042,1221,-109,-12,-97,NA,0,0,0,0,0,NA,NA
"761"," Pahrump"," NV","  West"," BLUE",2578,-2948,3443,6391,5505,-328,5833,1337,-356,379,735,1684,-63,1747,NA,0,0,0,0,0,NA,NA
"762"," Palatka"," FL","  South"," RED",144,-1310,7753,9063,1492,89,1403,478,-207,826,1033,681,-24,705,NA,0,0,0,0,0,NA,NA
"763"," Palestine"," TX","  South"," RED",-717,-752,5460,6212,67,293,-226,-239,-166,588,754,-72,32,-104,NA,0,0,0,0,0,NA,NA
"764"," Pampa"," TX","  South"," RED",-726,472,2963,2491,-1232,90,-1322,-209,4,267,263,-216,-1,-215,NA,0,0,0,0,0,NA,NA
"765"," Paragould"," AR","  South"," RED",3235,840,5289,4449,2396,48,2348,-14,82,587,505,-94,-7,-87,NA,0,0,0,0,0,NA,NA
"766"," Paris"," TN","  South"," RED",-4,-1216,3046,4262,1241,21,1220,9,-181,300,481,192,-5,197,NA,0,0,0,0,0,NA,NA
"767"," Paris"," TX","  South"," RED",68,388,6062,5674,-303,31,-334,130,-42,619,661,174,2,172,NA,0,0,0,0,0,NA,NA
"768"," Parsons"," KS","  Midwest"," RED",-1991,35,2466,2431,-2042,12,-2054,-288,26,248,222,-315,-3,-312,NA,0,0,0,0,0,NA,NA
"769"," Payson"," AZ","  West"," RED",426,-1531,5452,6983,1994,212,1782,217,-297,514,811,513,9,504,NA,0,0,0,0,0,NA,NA
"770"," Pearsall"," TX","  South"," RED",3089,1071,2322,1251,2001,1825,176,95,93,251,158,1,236,-235,NA,0,0,0,0,0,NA,NA
"771"," Pecos"," TX","  South"," RED",2280,745,1730,985,1496,620,876,484,81,187,106,401,51,350,NA,0,0,0,0,0,NA,NA
"772"," Pella"," IA","  Midwest"," RED",-54,258,3364,3106,-306,100,-406,-6,13,340,327,-19,4,-23,NA,0,0,0,0,0,NA,NA
"773"," Peru"," IN","  Midwest"," RED",-1389,57,3454,3397,-1453,128,-1581,-130,18,382,364,-149,26,-175,NA,0,0,0,0,0,NA,NA
"774"," Picayune"," MS","  South"," RED",-204,-31,5861,5892,-151,-200,49,212,-71,610,681,285,-30,315,NA,0,0,0,0,0,NA,NA
"775"," Pierre"," SD","  Midwest"," RED",636,1025,2531,1506,-388,-33,-355,-76,97,265,168,-174,-2,-172,NA,0,0,0,0,0,NA,NA
"776"," Pinehurst"," NC","  South"," RED",12630,-387,9688,10075,12924,799,12125,2075,-30,1139,1169,2101,78,2023,NA,0,0,0,0,0,NA,NA
"777"," Pittsburg"," KS","  Midwest"," RED",-317,659,4479,3820,-970,963,-1933,-93,87,448,361,-183,85,-268,NA,0,0,0,0,0,NA,NA
"778"," Plainview"," TX","  South"," RED",-2800,1667,4510,2843,-4540,142,-4682,-225,128,427,299,-354,0,-354,NA,0,0,0,0,0,NA,NA
"779"," Platteville"," WI","  Midwest"," RED",235,610,5137,4527,-391,209,-600,-5,90,561,471,-93,10,-103,NA,0,0,0,0,0,NA,NA
"780"," Plattsburgh"," NY","  Northeast"," BLUE",-1646,595,7100,6505,-2229,779,-3008,-194,12,756,744,-204,49,-253,NA,0,0,0,0,0,NA,NA
"781"," Plymouth"," IN","  Midwest"," RED",-792,1158,5419,4261,-1949,329,-2278,-38,105,582,477,-143,56,-199,NA,0,0,0,0,0,NA,NA
"782"," Point Pleasant"," WV","  South"," RED",-1876,-644,6006,6650,-1216,162,-1378,-283,-141,615,756,-137,13,-150,NA,0,0,0,0,0,NA,NA
"783"," Ponca City"," OK","  South"," RED",-3024,216,5610,5394,-3237,19,-3256,-406,-39,537,576,-365,-2,-363,NA,0,0,0,0,0,NA,NA
"784"," Pontiac"," IL","  Midwest"," BLUE",-3297,-135,3852,3987,-3221,276,-3497,-66,10,422,412,-74,32,-106,NA,0,0,0,0,0,NA,NA
"785"," Poplar Bluff"," MO","  Midwest"," RED",-1132,-395,6594,6989,-685,-15,-670,-241,-135,635,770,-106,1,-107,NA,0,0,0,0,0,NA,NA
"786"," Portales"," NM","  West"," BLUE",-1340,1195,2596,1401,-2592,368,-2960,-259,108,253,145,-369,34,-403,NA,0,0,0,0,0,NA,NA
"787"," Port Angeles"," WA","  West"," BLUE",5935,-2818,6116,8934,8734,503,8231,780,-429,632,1061,1206,44,1162,NA,0,0,0,0,0,NA,NA
"788"," Port Lavaca"," TX","  South"," RED",-92,757,2649,1892,-845,281,-1126,-214,44,262,218,-259,8,-267,NA,0,0,0,0,0,NA,NA
"789"," Portsmouth"," OH","  Midwest"," RED",-4336,-891,8120,9011,-3446,219,-3665,-166,-133,825,958,-31,8,-39,NA,0,0,0,0,0,NA,NA
"790"," Pottsville"," PA","  Northeast"," RED",-6931,-5037,12805,17842,-1787,464,-2251,-456,-496,1282,1778,50,23,27,NA,0,0,0,0,0,NA,NA
"791"," Price"," UT","  West"," RED",-940,519,2560,2041,-1482,68,-1550,230,47,231,184,182,2,180,NA,0,0,0,0,0,NA,NA
"792"," Prineville"," OR","  West"," BLUE",3426,-309,1983,2292,3708,-54,3762,579,-7,259,266,585,-11,596,NA,0,0,0,0,0,NA,NA
"793"," Pullman"," WA","  West"," BLUE",5326,1551,3984,2433,3691,3739,-48,421,151,390,239,272,393,-121,NA,0,0,0,0,0,NA,NA
"794"," Quincy"," IL","  Midwest"," BLUE",-2095,207,8627,8420,-2266,215,-2481,-251,-52,901,953,-196,16,-212,NA,0,0,0,0,0,NA,NA
"795"," Raymondville"," TX","  South"," RED",-778,1176,2724,1548,-1965,112,-2077,-92,69,252,183,-163,5,-168,NA,0,0,0,0,0,NA,NA
"796"," Red Bluff"," CA","  West"," BLUE",1644,1179,7041,5862,505,-131,636,1066,78,739,661,985,-29,1014,NA,0,0,0,0,0,NA,NA
"797"," Red Wing"," MN","  Midwest"," BLUE",156,346,4745,4399,-162,110,-272,41,49,503,454,-7,3,-10,NA,0,0,0,0,0,NA,NA
"798"," Rexburg"," ID","  West"," RED",2221,9669,11868,2199,-7529,301,-7830,590,1058,1291,233,-463,-7,-456,NA,0,0,0,0,0,NA,NA
"799"," Richmond"," IN","  Midwest"," RED",-3112,-628,7229,7857,-2466,303,-2769,-162,-109,757,866,-52,70,-122,NA,0,0,0,0,0,NA,NA
"800"," Richmond"," KY","  South"," RED",9501,2067,10636,8569,7365,653,6712,836,169,1123,954,668,3,665,NA,0,0,0,0,0,NA,NA
"801"," Rio Grande City"," TX","  South"," RED",3666,8374,12035,3661,-4744,754,-5498,384,778,1178,400,-397,-10,-387,NA,0,0,0,0,0,NA,NA
"802"," Riverton"," WY","  West"," RED",-862,1255,5266,4011,-2137,-32,-2105,-300,20,505,485,-319,-3,-316,NA,0,0,0,0,0,NA,NA
"803"," Roanoke Rapids"," NC","  South"," RED",-7237,-1706,7040,8746,-5551,194,-5745,-839,-290,713,1003,-549,16,-565,NA,0,0,0,0,0,NA,NA
"804"," Rochelle"," IL","  Midwest"," BLUE",-2847,275,4920,4645,-3154,122,-3276,-138,30,525,495,-167,5,-172,NA,0,0,0,0,0,NA,NA
"805"," Rockingham"," NC","  South"," RED",-1818,42,5087,5045,-1849,34,-1883,-59,3,559,556,-61,3,-64,NA,0,0,0,0,0,NA,NA
"806"," Rockport"," TX","  South"," RED",352,-969,2240,3209,1255,-18,1273,64,-172,193,365,236,-11,247,NA,0,0,0,0,0,NA,NA
"807"," Rock Springs"," WY","  West"," RED",-1463,2909,5555,2646,-4461,59,-4520,-515,208,506,298,-727,23,-750,NA,0,0,0,0,0,NA,NA
"808"," Rolla"," MO","  Midwest"," RED",-551,669,4748,4079,-1246,1736,-2982,22,40,461,421,-18,173,-191,NA,0,0,0,0,0,NA,NA
"809"," Roseburg"," OR","  West"," BLUE",3296,-3255,10023,13278,6637,-47,6684,866,-408,1065,1473,1274,-35,1309,NA,0,0,0,0,0,NA,NA
"810"," Roswell"," NM","  West"," BLUE",-1033,2282,8366,6084,-3293,509,-3802,61,184,819,635,-122,26,-148,NA,0,0,0,0,0,NA,NA
"811"," Ruidoso"," NM","  West"," BLUE",-921,-229,1689,1918,-695,138,-833,54,-33,174,207,89,18,71,NA,0,0,0,0,0,NA,NA
"812"," Russellville"," AR","  South"," RED",1477,2092,9877,7785,-606,681,-1287,357,186,1023,837,172,9,163,NA,0,0,0,0,0,NA,NA
"813"," Ruston"," LA","  South"," RED",2,1711,5230,3519,-1716,1202,-2918,-370,99,516,417,-471,85,-556,NA,0,0,0,0,0,NA,NA
"814"," Rutland"," VT","  Northeast"," BLUE",-3469,-1379,4906,6285,-2077,113,-2190,-405,-171,498,669,-234,8,-242,NA,0,0,0,0,0,NA,NA
"815"," Safford"," AZ","  West"," RED",1625,2507,5180,2673,-910,322,-1232,842,203,526,323,637,30,607,NA,0,0,0,0,0,NA,NA
"816"," St. Marys"," GA","  South"," RED",4154,4249,7342,3093,-117,559,-676,1015,396,768,372,616,-29,645,NA,0,0,0,0,0,NA,NA
"817"," St. Marys"," PA","  Northeast"," RED",-2036,-819,2772,3591,-1210,11,-1221,-200,-91,268,359,-108,1,-109,NA,0,0,0,0,0,NA,NA
"818"," Salem"," OH","  Midwest"," RED",-5969,-1480,9886,11366,-4458,69,-4527,-590,-204,982,1186,-383,-1,-382,NA,0,0,0,0,0,NA,NA
"819"," Salina"," KS","  Midwest"," RED",-1767,1692,7285,5593,-3444,191,-3635,-211,164,721,557,-375,3,-378,NA,0,0,0,0,0,NA,NA
"820"," Sandpoint"," ID","  West"," RED",4862,-133,3769,3902,4969,21,4948,1034,-12,426,438,1044,-13,1057,NA,0,0,0,0,0,NA,NA
"821"," Sandusky"," OH","  Midwest"," RED",-2797,-1347,7282,8629,-1405,193,-1598,-247,-138,778,916,-106,-6,-100,NA,0,0,0,0,0,NA,NA
"822"," Sanford"," NC","  South"," RED",3930,2196,7321,5125,1751,599,1152,571,211,774,563,360,56,304,NA,0,0,0,0,0,NA,NA
"823"," Sault Ste. Marie"," MI","  Midwest"," RED",-1323,-114,3195,3309,-1224,274,-1498,-112,-56,318,374,-54,3,-57,NA,0,0,0,0,0,NA,NA
"824"," Sayre"," PA","  Northeast"," RED",-2377,162,6539,6377,-2535,198,-2733,-471,-93,632,725,-377,16,-393,NA,0,0,0,0,0,NA,NA
"825"," Scottsbluff"," NE","  Midwest"," RED",-1442,754,4666,3912,-2201,200,-2401,-307,81,475,394,-387,23,-410,NA,0,0,0,0,0,NA,NA
"826"," Scottsboro"," AL","  South"," RED",-1597,-1121,5239,6360,-431,147,-578,5,-113,562,675,121,-7,128,NA,0,0,0,0,0,NA,NA
"827"," Scottsburg"," IN","  Midwest"," RED",-322,-272,2583,2855,-44,107,-151,89,-48,262,310,137,20,117,NA,0,0,0,0,0,NA,NA
"828"," Searcy"," AR","  South"," RED",1667,1266,8890,7624,419,272,147,372,44,881,837,333,-27,360,NA,0,0,0,0,0,NA,NA
"829"," Sedalia"," MO","  Midwest"," RED",125,1359,5384,4025,-1209,288,-1497,-102,153,577,424,-255,15,-270,NA,0,0,0,0,0,NA,NA
"830"," Selinsgrove"," PA","  Northeast"," RED",651,632,3904,3272,56,141,-85,-146,41,426,385,-186,5,-191,NA,0,0,0,0,0,NA,NA
"831"," Selma"," AL","  South"," RED",-6617,-178,4760,4938,-6484,6,-6490,-1098,-104,438,542,-997,5,-1002,NA,0,0,0,0,0,NA,NA
"832"," Seneca"," SC","  South"," RED",5261,-1048,7071,8119,6311,918,5393,1239,-257,701,958,1493,150,1343,NA,0,0,0,0,0,NA,NA
"833"," Seneca Falls"," NY","  Northeast"," BLUE",-1232,204,3351,3147,-1431,126,-1557,-163,5,318,313,-167,8,-175,NA,0,0,0,0,0,NA,NA
"834"," Sevierville"," TN","  South"," RED",8530,410,9656,9246,8085,1395,6690,355,-38,1025,1063,399,169,230,NA,0,0,0,0,0,NA,NA
"835"," Seymour"," IN","  Midwest"," RED",1855,1167,5431,4264,708,908,-200,163,135,591,456,29,114,-85,NA,0,0,0,0,0,NA,NA
"836"," Shawano"," WI","  Midwest"," RED",-732,295,4900,4605,-1005,192,-1197,89,88,533,445,4,8,-4,NA,0,0,0,0,0,NA,NA
"837"," Shawnee"," OK","  South"," RED",3149,756,8357,7601,2427,239,2188,79,5,846,841,78,20,58,NA,0,0,0,0,0,NA,NA
"838"," Shelby"," NC","  South"," RED",-85,-922,9997,10919,916,463,453,428,-117,1102,1219,548,44,504,NA,0,0,0,0,0,NA,NA
"839"," Shelbyville"," TN","  South"," RED",4656,1474,5848,4374,3185,657,2528,567,196,678,482,371,88,283,NA,0,0,0,0,0,NA,NA
"840"," Shelton"," WA","  West"," BLUE",6079,-144,5926,6070,6237,1032,5205,1388,-3,666,669,1388,130,1258,NA,0,0,0,0,0,NA,NA
"841"," Sheridan"," WY","  West"," RED",1361,104,3026,2922,1270,140,1130,266,-38,308,346,303,14,289,NA,0,0,0,0,0,NA,NA
"842"," Show Low"," AZ","  West"," RED",3436,5361,14474,9113,-1895,514,-2409,682,330,1447,1117,355,44,311,NA,0,0,0,0,0,NA,NA
"843"," Sidney"," OH","  Midwest"," RED",-865,1574,5683,4109,-2460,551,-3011,-32,171,613,442,-205,34,-239,NA,0,0,0,0,0,NA,NA
"844"," Sikeston"," MO","  Midwest"," RED",-919,651,4643,3992,-1545,30,-1575,-261,28,482,454,-286,-6,-280,NA,0,0,0,0,0,NA,NA
"845"," Silver City"," NM","  West"," BLUE",-2514,-367,2765,3132,-2131,58,-2189,-305,-69,256,325,-231,-10,-221,NA,0,0,0,0,0,NA,NA
"846"," Snyder"," TX","  South"," RED",-216,633,2232,1599,-853,81,-934,-109,21,203,182,-130,6,-136,NA,0,0,0,0,0,NA,NA
"847"," Somerset"," KY","  South"," RED",1918,-475,6922,7397,2449,225,2224,395,-36,755,791,432,-2,434,NA,0,0,0,0,0,NA,NA
"848"," Somerset"," PA","  Northeast"," RED",-4284,-2723,6235,8958,-1498,260,-1758,-425,-300,638,938,-120,17,-137,NA,0,0,0,0,0,NA,NA
"849"," Sonora"," CA","  West"," BLUE",-890,-1651,4283,5934,784,321,463,91,-155,466,621,252,20,232,NA,0,0,0,0,0,NA,NA
"850"," Spearfish"," SD","  Midwest"," RED",1754,36,2158,2122,1697,299,1398,117,-9,224,233,127,17,110,NA,0,0,0,0,0,NA,NA
"851"," Spencer"," IA","  Midwest"," RED",-651,91,1830,1739,-737,39,-776,-90,38,201,163,-129,4,-133,NA,0,0,0,0,0,NA,NA
"852"," Spirit Lake"," IA","  Midwest"," RED",591,-369,1473,1842,974,59,915,137,-31,147,178,168,5,163,NA,0,0,0,0,0,NA,NA
"853"," Starkville"," MS","  South"," RED",1355,2179,6298,4119,-861,861,-1722,239,143,660,517,96,111,-15,NA,0,0,0,0,0,NA,NA
"854"," Statesboro"," GA","  South"," RED",9365,3270,8052,4782,5980,1037,4943,2366,329,890,561,2019,84,1935,NA,0,0,0,0,0,NA,NA
"855"," Steamboat Springs"," CO","  West"," BLUE",2132,1022,2016,994,1087,480,607,131,74,207,133,57,43,14,NA,0,0,0,0,0,NA,NA
"856"," Stephenville"," TX","  South"," RED",4803,1459,4475,3016,3307,92,3215,475,145,480,335,329,-7,336,NA,0,0,0,0,0,NA,NA
"857"," Sterling"," CO","  West"," BLUE",-300,209,2109,1900,-518,57,-575,141,22,217,195,121,6,115,NA,0,0,0,0,0,NA,NA
"858"," Sterling"," IL","  Midwest"," BLUE",-3326,-196,5861,6057,-3128,-2,-3126,-378,-39,610,649,-337,-7,-330,NA,0,0,0,0,0,NA,NA
"859"," Stevens Point"," WI","  Midwest"," RED",751,1537,6382,4845,-749,822,-1571,-78,155,658,503,-233,50,-283,NA,0,0,0,0,0,NA,NA
"860"," Stillwater"," OK","  South"," RED",4437,3002,8191,5189,1453,4134,-2681,-388,223,815,592,-618,396,-1014,NA,0,0,0,0,0,NA,NA
"861"," Storm Lake"," IA","  Midwest"," RED",-645,1190,2886,1696,-1846,721,-2567,-206,138,286,148,-345,40,-385,NA,0,0,0,0,0,NA,NA
"862"," Sturgis"," MI","  Midwest"," RED",-339,1502,7324,5822,-1821,320,-2141,52,144,726,582,-91,22,-113,NA,0,0,0,0,0,NA,NA
"863"," Sulphur Springs"," TX","  South"," RED",1921,640,4239,3599,1290,-70,1360,346,58,444,386,287,-9,296,NA,0,0,0,0,0,NA,NA
"864"," Summerville"," GA","  South"," RED",-1233,-263,2673,2936,-977,50,-1027,7,-11,299,310,18,5,13,NA,0,0,0,0,0,NA,NA
"865"," Sunbury"," PA","  Northeast"," RED",-3633,-2066,8727,10793,-1497,220,-1717,-237,-205,888,1093,-26,-8,-18,NA,0,0,0,0,0,NA,NA
"866"," Susanville"," CA","  West"," BLUE",-4322,638,2774,2136,-5081,115,-5196,-45,79,281,202,-126,7,-133,NA,0,0,0,0,0,NA,NA
"867"," Sweetwater"," TX","  South"," RED",-499,216,1853,1637,-719,124,-843,-85,14,187,173,-100,15,-115,NA,0,0,0,0,0,NA,NA
"868"," Tahlequah"," OK","  South"," RED",1665,803,5469,4666,884,343,541,50,22,556,534,31,42,-11,NA,0,0,0,0,0,NA,NA
"869"," Talladega"," AL","  South"," RED",-2375,-1177,7978,9155,-1152,321,-1473,-159,-200,844,1044,46,32,14,NA,0,0,0,0,0,NA,NA
"870"," Taos"," NM","  West"," BLUE",-210,18,2763,2745,-205,175,-380,24,-46,271,317,72,-14,86,NA,0,0,0,0,0,NA,NA
"871"," Taylorville"," IL","  Midwest"," BLUE",-2491,-634,3185,3819,-1857,31,-1888,-349,-72,324,396,-276,-1,-275,NA,0,0,0,0,0,NA,NA
"872"," The Dalles"," OR","  West"," BLUE",1471,-56,2829,2885,1532,69,1463,250,0,299,299,251,3,248,NA,0,0,0,0,0,NA,NA
"873"," Thomaston"," GA","  South"," RED",-829,-411,2990,3401,-414,-18,-396,135,-94,306,400,234,-4,238,NA,0,0,0,0,0,NA,NA
"874"," Thomasville"," GA","  South"," RED",-272,567,5253,4686,-809,190,-999,117,15,531,516,105,18,87,NA,0,0,0,0,0,NA,NA
"875"," Tiffin"," OH","  Midwest"," RED",-1564,-46,5416,5462,-1513,466,-1979,-16,28,589,561,-42,34,-76,NA,0,0,0,0,0,NA,NA
"876"," Tifton"," GA","  South"," RED",508,1517,5219,3702,-1056,21,-1077,102,135,554,419,-34,-4,-30,NA,0,0,0,0,0,NA,NA
"877"," Toccoa"," GA","  South"," RED",-228,-357,2846,3203,142,3,139,-82,-39,317,356,-42,0,-42,NA,0,0,0,0,0,NA,NA
"878"," Torrington"," CT","  Northeast"," BLUE",-9547,-3159,13334,16493,-6375,2276,-8651,-762,-456,1382,1838,-299,263,-562,NA,0,0,0,0,0,NA,NA
"879"," Traverse City"," MI","  Midwest"," RED",7286,-403,13131,13534,7712,306,7406,842,-73,1402,1475,918,15,903,NA,0,0,0,0,0,NA,NA
"880"," Troy"," AL","  South"," RED",213,497,3463,2966,-313,947,-1260,-128,6,345,339,-131,79,-210,NA,0,0,0,0,0,NA,NA
"881"," Truckee"," CA","  West"," BLUE",1008,-1690,7428,9118,2792,101,2691,247,-208,778,986,462,-3,465,NA,0,0,0,0,0,NA,NA
"882"," Tullahoma"," TN","  South"," RED",5007,-900,10386,11286,5949,242,5707,947,8,1172,1164,941,36,905,NA,0,0,0,0,0,NA,NA
"883"," Tupelo"," MS","  South"," RED",4595,3725,20110,16385,940,339,601,420,320,2101,1781,109,50,59,NA,0,0,0,0,0,NA,NA
"884"," Ukiah"," CA","  West"," BLUE",-1101,1685,9521,7836,-2718,-153,-2565,-652,73,933,860,-720,-60,-660,NA,0,0,0,0,0,NA,NA
"885"," Union"," SC","  South"," RED",-1657,-673,2858,3531,-978,-16,-962,-8,-84,294,378,79,-1,80,NA,0,0,0,0,0,NA,NA
"886"," Union City"," TN","  South"," RED",-1738,-384,3195,3579,-1353,9,-1362,-205,-89,328,417,-116,5,-121,NA,0,0,0,0,0,NA,NA
"887"," Urbana"," OH","  Midwest"," RED",-1216,98,3752,3654,-1312,89,-1401,100,14,412,398,90,3,87,NA,0,0,0,0,0,NA,NA
"888"," Uvalde"," TX","  South"," RED",336,1413,3701,2288,-1054,146,-1200,-46,125,378,253,-171,-36,-135,NA,0,0,0,0,0,NA,NA
"889"," Van Wert"," OH","  Midwest"," RED",-484,185,3099,2914,-661,72,-733,22,44,339,295,-21,-1,-20,NA,0,0,0,0,0,NA,NA
"890"," Vermillion"," SD","  Midwest"," RED",204,443,1355,912,-247,200,-447,87,51,131,80,37,-1,38,NA,0,0,0,0,0,NA,NA
"891"," Vernal"," UT","  West"," RED",3146,3880,5965,2085,-822,151,-973,329,305,536,231,25,15,10,NA,0,0,0,0,0,NA,NA
"892"," Vernon"," TX","  South"," RED",-766,81,1515,1434,-858,78,-936,-8,11,154,143,-18,2,-20,NA,0,0,0,0,0,NA,NA
"893"," Vicksburg"," MS","  South"," RED",-3389,835,5682,4847,-4224,152,-4376,-712,58,576,518,-770,16,-786,NA,0,0,0,0,0,NA,NA
"894"," Vidalia"," GA","  South"," RED",-349,928,4530,3602,-1270,-18,-1252,-68,80,474,394,-146,-14,-132,NA,0,0,0,0,0,NA,NA
"895"," Vincennes"," IN","  Midwest"," RED",-1846,94,4143,4049,-1941,116,-2057,-2,-4,390,394,3,20,-17,NA,0,0,0,0,0,NA,NA
"896"," Vineyard Haven"," MA","  Northeast"," BLUE",797,184,1510,1326,615,2,613,3,25,171,146,-20,-1,-19,NA,0,0,0,0,0,NA,NA
"897"," Wabash"," IN","  Midwest"," RED",-1892,-796,3112,3908,-1092,66,-1158,-202,-100,306,406,-103,10,-113,NA,0,0,0,0,0,NA,NA
"898"," Wahpeton"," ND","  Midwest"," RED",-513,362,2353,1991,-869,-63,-806,-89,54,263,209,-144,-12,-132,NA,0,0,0,0,0,NA,NA
"899"," Wapakoneta"," OH","  Midwest"," RED",-261,651,5111,4460,-899,262,-1161,-80,66,559,493,-147,18,-165,NA,0,0,0,0,0,NA,NA
"900"," Warren"," PA","  Northeast"," RED",-2620,-982,3714,4696,-1618,87,-1705,-360,-114,417,531,-245,5,-250,NA,0,0,0,0,0,NA,NA
"901"," Warrensburg"," MO","  Midwest"," RED",1497,2915,6608,3693,-1425,1029,-2454,441,308,686,378,135,41,94,NA,0,0,0,0,0,NA,NA
"902"," Warsaw"," IN","  Midwest"," RED",2101,3086,9530,6444,-924,502,-1426,40,305,1029,724,-261,85,-346,NA,0,0,0,0,0,NA,NA
"903"," Washington"," IN","  Midwest"," RED",1697,1875,4951,3076,-163,160,-323,73,212,539,327,-142,21,-163,NA,0,0,0,0,0,NA,NA
"904"," Washington"," NC","  South"," RED",-790,-1057,4392,5449,310,15,295,-62,-189,439,628,131,3,128,NA,0,0,0,0,0,NA,NA
"905"," Washington Court House"," OH","  Midwest"," RED",-509,-98,3193,3291,-391,96,-487,-128,21,330,309,-147,4,-151,NA,0,0,0,0,0,NA,NA
"906"," Watertown"," SD","  Midwest"," RED",1049,1622,4459,2837,-559,220,-779,70,145,435,290,-73,4,-77,NA,0,0,0,0,0,NA,NA
"907"," Watertown"," WI","  Midwest"," RED",1081,1945,8070,6125,-810,335,-1145,-280,141,835,694,-422,28,-450,NA,0,0,0,0,0,NA,NA
"908"," Wauchula"," FL","  South"," RED",-800,1603,3529,1926,-2431,313,-2744,-231,146,339,193,-378,-2,-376,NA,0,0,0,0,0,NA,NA
"909"," Waycross"," GA","  South"," RED",141,725,6764,6039,-582,-12,-570,224,58,739,681,166,-14,180,NA,0,0,0,0,0,NA,NA
"910"," Weatherford"," OK","  South"," RED",1463,1378,4079,2701,56,540,-484,8,121,398,277,-113,55,-168,NA,0,0,0,0,0,NA,NA
"911"," West Plains"," MO","  Midwest"," RED",-269,81,4732,4651,-320,101,-421,-9,-4,504,508,-2,9,-11,NA,0,0,0,0,0,NA,NA
"912"," West Point"," MS","  South"," RED",-1332,-83,2083,2166,-1246,36,-1282,-88,-21,209,230,-66,4,-70,NA,0,0,0,0,0,NA,NA
"913"," Whitewater"," WI","  Midwest"," RED",1638,843,9303,8460,857,57,800,318,-23,924,947,343,-23,366,NA,0,0,0,0,0,NA,NA
"914"," Williston"," ND","  Midwest"," RED",15190,3400,5527,2127,11403,170,11233,2120,491,725,234,1624,23,1601,NA,0,0,0,0,0,NA,NA
"915"," Willmar"," MN","  Midwest"," BLUE",960,1809,5364,3555,-844,1690,-2534,289,198,568,370,93,193,-100,NA,0,0,0,0,0,NA,NA
"916"," Wilmington"," OH","  Midwest"," RED",-80,542,4617,4075,-610,115,-725,-117,12,470,458,-126,3,-129,NA,0,0,0,0,0,NA,NA
"917"," Wilson"," NC","  South"," RED",577,974,8873,7899,-334,689,-1023,409,0,944,944,413,77,336,NA,0,0,0,0,0,NA,NA
"918"," Winfield"," KS","  Midwest"," RED",-1401,91,4055,3964,-1494,337,-1831,-241,-20,393,413,-221,19,-240,NA,0,0,0,0,0,NA,NA
"919"," Winnemucca"," NV","  West"," BLUE",310,1160,2304,1144,-879,2,-881,53,109,221,112,-56,-1,-55,NA,0,0,0,0,0,NA,NA
"920"," Winona"," MN","  Midwest"," BLUE",-977,519,4348,3829,-1502,521,-2023,-251,16,456,440,-267,25,-292,NA,0,0,0,0,0,NA,NA
"921"," Wisconsin Rapids"," WI","  Midwest"," RED",-1751,485,7627,7142,-2226,220,-2446,45,74,798,724,-25,17,-42,NA,0,0,0,0,0,NA,NA
"922"," Woodward"," OK","  South"," RED",-165,852,3117,2265,-1056,295,-1351,-181,17,290,273,-199,29,-228,NA,0,0,0,0,0,NA,NA
"923"," Wooster"," OH","  Midwest"," RED",1194,3917,14085,10168,-2673,877,-3550,-80,296,1446,1150,-377,47,-424,NA,0,0,0,0,0,NA,NA
"924"," Worthington"," MN","  Midwest"," BLUE",251,1745,3415,1670,-1524,1377,-2901,-115,196,382,186,-312,87,-399,NA,0,0,0,0,0,NA,NA
"925"," Yankton"," SD","  Midwest"," RED",376,404,2489,2085,-10,57,-67,55,54,261,207,3,1,2,NA,0,0,0,0,0,NA,NA
"926"," Zanesville"," OH","  Midwest"," RED",129,515,9519,9004,-326,541,-867,84,31,1002,971,58,43,15,NA,0,0,0,0,0,NA,NA
"927"," Zapata"," TX","  South"," RED",161,1654,2501,847,-1501,15,-1516,30,104,214,110,-75,-9,-66,NA,0,0,0,0,0,NA,NA
